Cellphone Picture Mystery
An Interactive Fiction by Crystal Yee
Release 1 / Serial number 130306 / Inform 7 build 6G60 (I6/v6.32 lib 6/12N) SD

Rocky Field
A dirt covered field with rocks scattered about. A high cliff looms above casting a shadow over much of the field. You can see a Tree Lined Trail to the north and a Grassy Meadow to the west.

You can see Keycard here.

>take all
(Keycard)
Taken.

>n
Tree Lined Trail
A fairly normal hiking trail full of pine trees. A bush lies ostentaniously on the left hand side of the trail. You can see the a Rocky Field to the south, a Forest Clearing to the northeast and a Bridge to the east.

>take all
(Keycard)
You already have that.

>take saw
Taken.

>cut keycard
Cutting that up would achieve little.

* * *

Cellphone Picture Mystery
An Interactive Fiction by Crystal Yee
Release 1 / Serial number 130306 / Inform 7 build 6G60 (I6/v6.32 lib 6/12N) SD

Rocky Field
A dirt covered field with rocks scattered about. A high cliff looms above casting a shadow over much of the field. You can see a Tree Lined Trail to the north and a Grassy Meadow to the west.

You can see Keycard here.

>take keycard
Taken.

>n
Tree Lined Trail
A fairly normal hiking trail full of pine trees. A bush lies ostentaniously on the left hand side of the trail. You can see the a Rocky Field to the south, a Forest Clearing to the northeast and a Bridge to the east.

* * *

>take keycard
Taken.

>cut keycard
Cutting that up would achieve little.

* * *

>take keycard
Taken.

>cut keycard with saw
I don't have a saw.

>n
Tree Lined Trail
A fairly normal hiking trail full of pine trees. A bush lies ostentaniously on the left hand side of the trail. You can see the a Rocky Field to the south, a Forest Clearing to the northeast and a Bridge to the east.

* * *

>take saw
Taken.

>s
Rocky Field
A dirt covered field with rocks scattered about. A high cliff looms above casting a shadow over much of the field. You can see a Tree Lined Trail to the north and a Grassy Meadow to the west.

>cut keycard with saw
Cutting that up would achieve little.

* * *

Cellphone Picture Mystery
An Interactive Fiction by Crystal Yee
Release 1 / Serial number 130306 / Inform 7 build 6G60 (I6/v6.32 lib 6/12N) SD

Rocky Field
A dirt covered field with rocks scattered about. A high cliff looms above casting a shadow over much of the field. You can see a Tree Lined Trail to the north and a Grassy Meadow to the west.

You can see Keycard here.

>cut keycard
Cutting that up would achieve little.

* * *

Cellphone Picture Mystery
An Interactive Fiction by Crystal Yee
Release 1 / Serial number 130306 / Inform 7 build 6G60 (I6/v6.32 lib 6/12N) SD

Rocky Field
A dirt covered field with rocks scattered about. A high cliff looms above casting a shadow over much of the field. You can see a Tree Lined Trail to the north and a Grassy Meadow to the west.

You can see Keycard here.

>take key
Taken.

>w
Grassy Meadow
Patches of grass and wildflowers fill the meadow. It's surrounded by a rather tall fence. You can see a gate to the west.

You can see Gate here.

* * *

>w
(first opening Gate)
It seems to be locked.

>open gate with key
That doesn't seem to fit the lock.

* * *

Cellphone Picture Mystery
An Interactive Fiction by Crystal Yee
Release 1 / Serial number 130306 / Inform 7 build 6G60 (I6/v6.32 lib 6/12N) SD

Rocky Field
A dirt covered field with rocks scattered about. A high cliff looms above casting a shadow over much of the field. You can see a Tree Lined Trail to the north and a Grassy Meadow to the west.

You can see Keycard here.

>n
Tree Lined Trail
A fairly normal hiking trail full of pine trees. A bush lies ostentaniously on the left hand side of the trail. You can see the a Rocky Field to the south, a Forest Clearing to the northeast and a Bridge to the east.

>ne
Forest Clearing
Sunlight filters through the leaves of the trees above. You can see the Tree Lined Trail to the southwest and a Waterfall to the southeast.

>se
Waterfall
A huge waterfall roars above. You can see the Bridge to the west and the Forest Clearing to the northwest.

>w
Rocky Field
A dirt covered field with rocks scattered about. A high cliff looms above casting a shadow over much of the field. You can see a Tree Lined Trail to the north and a Bridge to the west.

* * *

>se
Waterfall
A huge waterfall roars above. You can see the Bridge to the west and the Forest Clearing to the northwest.

>nw
Forest Clearing
Sunlight filters through the leaves of the trees above. You can see the Tree Lined Trail to the southwest and a Waterfall to the southeast.

>se
Waterfall
A huge waterfall roars above. You can see the Bridge to the west and the Forest Clearing to the northwest.

>w
Bridge
A rope bridge built atop a flowing river. It occasionally sways from side to side making you question its architectural integrity. You can see a Tree Lined Trail to the west, and a Waterfall to the east.

>w
Tree Lined Trail
A fairly normal hiking trail full of pine trees. You can see the a Rocky Field to the south, a Forest Clearing to the northeast and a Bridge to the east.

* * *

>ne
Forest Clearing
Sunlight filters through the leaves of the trees above. You can see the Tree Lined Trail to the southwest and a Waterfall to the southeast.

>sw
Tree Lined Trail
A fairly normal hiking trail full of pine trees. You can see the a Rocky Field to the south, a Forest Clearing to the northeast and a Bridge to the east.

>e
Bridge
A rope bridge built atop a flowing river. It occasionally sways from side to side making you question its architectural integrity. You can see a Tree Lined Trail to the west, and a Waterfall to the east.

>e
Waterfall

* * *

>n
Tree Lined Trail
A fairly normal hiking trail full of pine trees. A bush lies ostentaniously on the left hand side of the trail. You can see the a Rocky Field to the south, a Forest Clearing to the northeast and a Bridge to the east.

>examine large metalic thing
You see nothing special about Saw.

>x bush
A bush that would fit right in to a suburban garden but looks out of place here. You can see a large metalic thing under the bush.

>look
Tree Lined Trail
A fairly normal hiking trail full of pine trees. A bush lies ostentaniously on the left hand side of the trail. You can see the a Rocky Field to the south, a Forest Clearing to the northeast and a Bridge to the east.

>look at bush
A bush that would fit right in to a suburban garden but looks out of place here. You can see a large metalic thing under the bush.

>examine metalic thing
You see nothing special about Saw.

* * *

I beg your pardon?

>look
Forest trail

>i
You are carrying:
  rock

>e
Bridge

I beg your pardon?

* * *

>take saw
Taken.

>s
Rocky Field
A dirt covered field with rocks scattered about. A high cliff looms above casting a shadow over much of the field. You can see a Tree Lined Trail to the north and a Grassy Meadow to the west.

You can see Keycard here.

>cut keycard with saw
It wouldn't be wise to cut that.

I beg your pardon?

* * *

>cut keycard with saw
It wouldn't be wise to cut that.

>e
You can't go that way.

* * *

>n
Tree Lined Trail
A fairly normal hiking trail full of pine trees. A bush lies ostentaniously on the left hand side of the trail. You can see the a Rocky Field to the south, a Forest Clearing to the northeast and a Bridge to the east.

>e
Bridge
A rope bridge built atop a flowing river. It occasionally sways from side to side making you question its architectural integrity. You can see a Tree Lined Trail to the west, and a Waterfall to the east.

You can see Rope here.

>cut rope with saw
You cut the rope

I beg your pardon?

* * *

>s
Rocky Field
A dirt covered field with rocks scattered about. A high cliff looms above casting a shadow over much of the field. You can see a Tree Lined Trail to the north and a Grassy Meadow to the west.

You can see Keycard here.

>cut keycard with say
I only understood you as far as wanting to cut Keycard.

>cut keycard with saw
Cutting that up would achieve little.

* * *

>e
Bridge
A rope bridge built atop a flowing river. It occasionally sways from side to side making you question its architectural integrity. You can see a Tree Lined Trail to the west, and a Waterfall to the east.

>cut rope with saw
You cut the rope

* * *

>e
Bridge
A rope bridge built atop a flowing river. It occasionally sways from side to side making you question its architectural integrity. You can see a Tree Lined Trail to the west, and a Waterfall to the east.

>cut bridge with saw
You walk to the Waterfall side of the bridge placing yourself just off of the Bridge's rope structure. You cut off the rope supports of the bridge leaving a vast gap in the Bridge's place.

Waterfall
A huge waterfall roars above. You can see the Bridge to the west and the Forest Clearing to the northwest.

I beg your pardon?

* * *

>n
Tree Lined Trail
A fairly normal hiking trail full of pine trees. A bush lies ostentaniously on the left hand side of the trail. You can see the a Rocky Field to the south, a Forest Clearing to the northeast and a Bridge to the east.

>s
Rocky Field
A dirt covered field with rocks scattered about. A high cliff looms above casting a shadow over much of the field. You can see a Tree Lined Trail to the north and a Bridge to the west.

>n
Tree Lined Trail
A fairly normal hiking trail full of pine trees. You can see the a Rocky Field to the south, a Forest Clearing to the northeast and a Bridge to the east.

>ne
Forest Clearing

>se
Bridge
A rope bridge built atop a flowing river. It occasionally sways from side to side making you question its architectural integrity. You can see a Tree Lined Trail to the west, and a Waterfall to the east.

>nw
Forest Clearing

* * *

>n
Tree Lined Trail
A fairly normal hiking trail full of pine trees. A bush lies ostentaniously on the left hand side of the trail. You can see the a Rocky Field to the south, a Forest Clearing to the northeast and a Bridge to the east.

>examine bush
A bush that would fit right in to a suburban garden but looks out of place here. You can see something shiny under the bush.

* * *

Cellphone Picture Mystery
An Interactive Fiction by Crystal Yee
Release 1 / Serial number 130306 / Inform 7 build 6G60 (I6/v6.32 lib 6/12N) SD

Rocky Field
A dirt covered field with rocks scattered about. A high cliff looms above casting a shadow over much of the field. You can see a Tree Lined Trail to the north and a Grassy Meadow to the west.

You can see Keycard here.

>w
Grassy Meadow
Patches of grass and wildflowers fill the meadow. It's surrounded by a rather tall fence. You can see a gate to the west.

You can see Gate here.

* * *

>w
(first opening Gate)
It seems to be locked.

>w
(first opening Gate)
It seems to be locked.

* * *

>open gate
It seems to be locked.

>open gate with keycard
As you enter the key into the Digital Lock, a Screen lights up prompting you for a four digit code. The hint is "the last four digits of your phone number"