Cellphone Picture Mystery
An Interactive Fiction by Crystal Yee
Release 1 / Serial number 130314 / Inform 7 build 6G60 (I6/v6.32 lib 6/12N) SD

Rocky Field
A dirt covered field with rocks scattered about. A high cliff looms above casting a shadow over much of the field. You can see a Tree Lined Trail to the north and a Grassy Meadow to the west.

>next picture
(Picture Menu)

I beg your pardon?

>n
Tree Lined Trail
A fairly normal hiking trail full of pine trees. A bush lies ostentaniously on the left hand side of the trail. You can see the a Rocky Field to the south, a Forest Clearing to the northeast and a Bridge to the east.

* * *

Cellphone Picture Mystery
An Interactive Fiction by Crystal Yee
Release 1 / Serial number 130314 / Inform 7 build 6G60 (I6/v6.32 lib 6/12N) SD

Rocky Field
A dirt covered field with rocks scattered about. A high cliff looms above casting a shadow over much of the field. You can see a Tree Lined Trail to the north and a Grassy Meadow to the west.

>select picture menu
In Picture Menu are Picture 1, Picture 2 and Picture 3.

>examine picture menu
You see nothing special about Picture Menu.

* * *

I beg your pardon?

>x cell phone
You find yourself with a picture phone, presumably yours. Maybe you should look through the pictures and contacts for clues about your identity.

 A picture of a house. It's a modern one story model with solar panels and everything.   A picture of a woman with brown hair in a ponytail. She's wearing a navy blue coat and is carrying a rather large backpack. She's standing in front of a gate.

* * *

I beg your pardon?

>x cell phone
 A picture of a house. It's a modern one story model with solar panels and everything.   A picture of a woman with brown hair in a ponytail. She's wearing a navy blue coat and is carrying a rather large backpack. She's standing in front of a gate.

* * *

Cellphone Picture Mystery
An Interactive Fiction by Crystal Yee
Release 1 / Serial number 130314 / Inform 7 build 6G60 (I6/v6.32 lib 6/12N) SD

Rocky Field
A dirt covered field with rocks scattered about. A high cliff looms above casting a shadow over much of the field. You can see a Tree Lined Trail to the north and a Grassy Meadow to the west.

>x cell phone
You find yourself with a picture phone, presumably yours. Maybe you should look through the pictures and contacts for clues about your identity.

 A picture of a house. It's a modern one story model with solar panels and everything.

* * *

I beg your pardon?

>x cell phone
  A picture of a woman with brown hair in a ponytail. She's wearing a navy blue coat and is carrying a rather large backpack. She's standing in front of a gate.

* * *

>picture
Which do you mean, Picture or Picture Menu?

* * *

Cellphone Picture Mystery
An Interactive Fiction by Crystal Yee
Release 1 / Serial number 130314 / Inform 7 build 6G60 (I6/v6.32 lib 6/12N) SD

Rocky Field
A dirt covered field with rocks scattered about. A high cliff looms above casting a shadow over much of the field. You can see a Tree Lined Trail to the north and a Grassy Meadow to the west.

>select cell phone
You see nothing special about Cell Phone.

* * *

Cellphone Picture Mystery
An Interactive Fiction by Crystal Yee
Release 1 / Serial number 130314 / Inform 7 build 6G60 (I6/v6.32 lib 6/12N) SD

Rocky Field
A dirt covered field with rocks scattered about. A high cliff looms above casting a shadow over much of the field. You can see a Tree Lined Trail to the north and a Grassy Meadow to the west.

>call mom
You can't see any such thing.

>call mom's number
I try calling, but it appears that I'm out of range. Maybe if I could get to civilization…

* * *

Cellphone Picture Mystery
An Interactive Fiction by Crystal Yee
Release 1 / Serial number 130314 / Inform 7 build 6G60 (I6/v6.32 lib 6/12N) SD

Rocky Field
A dirt covered field with rocks scattered about. A high cliff looms above casting a shadow over much of the field. You can see a Tree Lined Trail to the north and a Grassy Meadow to the west.

>i
You are carrying:
  Cell Phone

>open picture menu
You open Picture Menu, revealing Picture 1, Picture 2 and Picture 3.

>look at picture 1
A picture of a house. It's a modern one story model with solar panels and everything.

* * *

>i
You are carrying:
  Cell Phone

>x cell phone
You see nothing special about Cell Phone.

>open picture menu
That's not something you can open.

* * *

Cellphone Picture Mystery
An Interactive Fiction by Crystal Yee
Release 1 / Serial number 130314 / Inform 7 build 6G60 (I6/v6.32 lib 6/12N) SD

Rocky Field
A dirt covered field with rocks scattered about. A high cliff looms above casting a shadow over much of the field. You can see a Tree Lined Trail to the north and a Grassy Meadow to the west.

>n
Tree Lined Trail
A fairly normal hiking trail full of pine trees.  You can see the a Rocky Field to the south, a Forest Clearing to the northeast and a Bridge to the east.

>select bush
A bush that would fit right in to a suburban garden but looks out of place here. You can see a large metalic thing under the bush.

* * *

>n
Tree Lined Trail
A fairly normal hiking trail full of pine trees.  You can see the a Rocky Field to the south, a Forest Clearing to the northeast and a Bridge to the east.

>e
Bridge
A rope bridge built atop a flowing river. It occasionally sways from side to side making you question its architectural integrity. You can see a Tree Lined Trail to the west, and a Waterfall to the east.

* * *

>e
Waterfall
A huge waterfall roars above. You can see the Bridge to the west and the Forest Clearing to the northwest.

You can see Telescope here.

>nw
Forest Clearing
Sunlight filters through the leaves of the trees above. You can see the Tree Lined Trail to the southwest and a Waterfall to the southeast.

You can see Kyle here.

>talk to kyle
"Shoots it's her" Kyle mutters before running towards the Tree Lined Trail.

>sw
Tree Lined Trail
A fairly normal hiking trail full of pine trees. A bush lies ostentaniously on the left hand side of the trail. You can see the a Rocky Field to the south, a Forest Clearing to the northeast and a Bridge to the east.

You can see Kyle here.

>talk to kyle
"Shoots it's her" Kyle mutters before running towards the Bridge.

>e
Bridge
A rope bridge built atop a flowing river. It occasionally sways from side to side making you question its architectural integrity. You can see a Tree Lined Trail to the west, and a Waterfall to the east.

You can see Kyle here.

* * *

>e
Bridge
A rope bridge built atop a flowing river. It occasionally sways from side to side making you question its architectural integrity. You can see a Tree Lined Trail to the west, and a Waterfall to the east.

>cut bridge
I don't have a saw.

* * *

>n
Tree Lined Trail
A fairly normal hiking trail full of pine trees.  You can see the a Rocky Field to the south, a Forest Clearing to the northeast and a Bridge to the east.

>take saw
Taken.

* * *

>cut bridge with saw
You walk right off of the easternmost side of the bridge. You cut the rope supports of the bridge and the wodden rope structure falls to the other side of the ravine. Now there's a vast gap in the bridge's place.

Waterfall
A huge waterfall roars above. You can see the Bridge to the west and the Forest Clearing to the northwest.

You can see Telescope here.

>nw
Forest Clearing
Sunlight filters through the leaves of the trees above. You can see the Tree Lined Trail to the southwest and a Waterfall to the southeast.

You can see Stranger here.

>talk to stranger
"Shoots it's her" Stranger mutters before running towards the Tree Lined Trail.

I beg your pardon?

* * *

>talk to stranger
"Shoots it's her" Stranger mutters before running towards the Tree Lined Trail.

>sw
Tree Lined Trail
A fairly normal hiking trail full of pine trees. A bush lies ostentaniously on the left hand side of the trail. You can see the a Rocky Field to the south, a Forest Clearing to the northeast and a Bridge to the east.

You can see Stranger here.

>talk to stranger
Stranger gawks at the broken bridge and runs towards the Rocky Field instead

>s
Rocky Field
A dirt covered field with rocks scattered about. A high cliff looms above casting a shadow over much of the field. You can see a Tree Lined Trail to the north and a Grassy Meadow to the west.

You can see Stranger and Keycard here.

>talk to stranger
"You're a persistant one" Stranger mutters as he sprints towards the grassy meadow

>w
Grassy Meadow
Patches of grass and wildflowers fill the meadow. It's surrounded by a rather tall fence. You can see a gate to the west and a pathway leading to the south.

You can see Gate and Stranger here.

>talk to stranger
"You're a persistant one" Stranger mutters as he sprints towards the southern path

>s
Cliff
A sheer cliff overlooking the Grassy Meadow.

You can see Stranger here.

>talk to stranger
After taking a look around, the Stranger sees that there is no where to run and resigns himself to his fate.
 "What are the chances that we'd end up here" he mutters to himself as you walk towards him.
"Who are you?" you ask.
"What?!?"
"I swear, I never even met you but you keep on running away""…""I think I lost my memory but for some reason I have pictures of you in my phone. Do you have any idea about who I am?"
"I see… You are not someone I know personally I am not against cooperating with you to get out of this place.who 
You agree to cooperate with the stranger.
By the way, my name is Landon.

>look
Cliff
A sheer cliff overlooking the Grassy Meadow.

You can see Landon here.

* * *

>cut bridge
Cutting that up would achieve little.

>cut bridge with saw
You walk right off of the easternmost side of the bridge. You cut the rope supports of the bridge and the wodden rope structure falls to the other side of the ravine. Now there's a vast gap in the bridge's place.

Waterfall
A huge waterfall roars above. You can see the Bridge to the west and the Forest Clearing to the northwest.

You can see Telescope here.

* * *

>talk to stranger
"Shoots it's her" Stranger mutters before running towards the Tree Lined Trail.

>sw
Tree Lined Trail
A fairly normal hiking trail full of pine trees.  You can see the a Rocky Field to the south, a Forest Clearing to the northeast and a Bridge to the east.

You can see Stranger here.

>talk to stranger
Stranger gawks at the broken bridge and runs towards the Rocky Field instead

>s
Rocky Field
A dirt covered field with rocks scattered about. A high cliff looms above casting a shadow over much of the field. You can see a Tree Lined Trail to the north and a Grassy Meadow to the west.

You can see Stranger here.

>talk to stranger
"You're a persistant one" Stranger mutters as he sprints towards the grassy meadow

* * *

>s
Cliff
A sheer cliff overlooking the Grassy Meadow.

You can see Stranger here.

>talk to stranger
After taking a look around, the Stranger sees that there is no where to run and resigns himself to his fate.
 "What are the chances that we'd end up here" he mutters to himself as you walk towards him.
"Who are you?" you ask.
"What?!?"
"I swear, I never even met you but you keep on running away""…""I think I lost my memory but for some reason I have pictures of you in my phone. Do you have any idea about who I am?"
"I see… You are not someone I know personally I am not against cooperating with you to get out of this place.
You agree to cooperate with the stranger.
"By the way, my name is Landon, Landon Meyers"

I beg your pardon?

>talk to landon
Landon shuffles with the backpack he's wearing and passes you a keycard. "This activates something in the gate, but doesn't open it" he says.

>i
You are carrying:
  Keycard
  Saw
  Cell phone

>n
Grassy Meadow
Patches of grass and wildflowers fill the meadow. It's surrounded by a rather tall fence. You can see a gate to the west and a pathway leading to the south.

You can see Gate and Landon here.

* * *

Cellphone Picture Mystery
An Interactive Fiction by Crystal Yee
Release 1 / Serial number 130314 / Inform 7 build 6G60 (I6/v6.32 lib 6/12N) SD

Rocky Field
A dirt covered field with rocks scattered about. A high cliff looms above casting a shadow over much of the field. You can see a Tree Lined Trail to the north and a Grassy Meadow to the west.

>next
You must supply a noun.

>next picture
I only understood you as far as wanting to next.

* * *

Cellphone Picture Mystery
An Interactive Fiction by Crystal Yee
Release 1 / Serial number 130314 / Inform 7 build 6G60 (I6/v6.32 lib 6/12N) SD

Rocky Field
A dirt covered field with rocks scattered about. A high cliff looms above casting a shadow over much of the field. You can see a Tree Lined Trail to the north and a Grassy Meadow to the west.

>x cellphone
You can't see any such thing.

>x cell phone
 A picture of a house. It's a modern one story model with solar panels and everything.   

You find yourself with a picture phone, presumably yours. Maybe you should look through the pictures and contacts for clues about your identity.