You wake up in an unfamiliar place with nothing but a cell phone. You don't remember who you are or what you're doing here. Use the clues on your phone and in the surrounding area to escape this place and to find your true identity.

Cellphone Picture Mystery
An Interactive Fiction by Crystal Yee The maximum score is 6
Release 1 / Serial number 130320 / Inform 7 build 6G60 (I6/v6.32 lib 6/12N) SD

Rocky Field
A dirt covered field with rocks scattered about. A dark shadow casts itself over much of the field. You can see a Pine Tree Trail to the north and a Grassy Meadow to the west.

You can see Cell Phone here.

>call mom
Someone in my contacts list called "Mom" should know about me right? I try calling, but it appears that I'm out of range. Maybe if I could get to civilization…pears that

>take cell phone
Taken.

>n
Pine Tree Trail
A fairly normal hiking trail full of pine trees.  You can see the a Rocky Field to the south, a Forest Clearing to the northeast and a Bridge to the east.

>take saw
Taken.

>e
Bridge
A rope bridge built atop a flowing river. It occasionally sways from side to side making you question its architectural integrity. You can see a Pine Tree Trail to the west, and a Waterfall to the east.

>cut bridge
You walk right off of the easternmost side of the bridge. You cut the rope supports of the bridge and the wodden rope structure falls to the other side of the ravine. Now there's a vast gap in the bridge's place.

Waterfall
A huge waterfall roars above. You can see the Bridge to the west and the Forest Clearing to the northwest.

You can see Telescope here.

>nw
Forest Clearing
Sunlight filters through the leaves of the trees above. You can see the Pine Tree Trail to the southwest and a Waterfall to the southeast.

You can see Stranger here.

>talk
(to Stranger)
"Shoots it's her" Stranger mutters before running towards the Pine Tree Trail.

>sw
Pine Tree Trail
A fairly normal hiking trail full of pine trees.  You can see the a Rocky Field to the south, a Forest Clearing to the northeast and a Bridge to the east.  

You can see Stranger here.

>talk
(to Stranger)
Stranger gawks at the broken bridge and runs towards the Rocky Field instead.

>s
Rocky Field
A dirt covered field with rocks scattered about. A high cliff looms above casting a shadow over much of the field. You can see a Pine Tree Trail to the north and a Grassy Meadow to the west.

You can see Stranger here.

>talk to strange
You can't see any such thing.

>talk
(to Stranger)
"You're a persistant one" Stranger mutters as he sprints towards the grassy meadow.

>w
Grassy Meadow
Patches of grass and wildflowers fill the meadow. It's surrounded by a rather tall fence. You can see a gate to the west, the Rocky Field to the east and a pathway leading to the south.

You can see Gate, Stranger and Daisy here.

>talk
(to Stranger)
"You're a persistant one" Stranger mutters as he sprints towards the southern path.

>s
Cliff
A sheer cliff overlooking the Rocky Field. The Grassy Meadow is to the north.

You can see Stranger here.

>talk
(to Stranger)
After taking a look around, the Stranger sees that there is no where to run and resigns himself to his fate.
 "What are the chances that we'd end up here" he mutters to himself as you walk towards him.
"Who are you?" you ask.
"What?!?"
"I swear, I never even met you but you keep on running away."
    "…"        "I think I lost my memory but for some reason I have pictures of you in my phone. Do you have any idea about who I am?"        "I see… You are not someone I know personally I am not against cooperating with you to get out of this place.⁮畲o I am⁮畲湮湩⁧睡컽͞"    You agree to cooperate with the stranger.
"By the way, my name is Landon, Landon Meyers."

>talk
(to Landon)
Landon shuffles with the backpack he's wearing and passes you a keycard. "This activates something in the gate, but doesn't open it" he says.

>n
Grassy Meadow
Patches of grass and wildflowers fill the meadow. It's surrounded by a rather tall fence. You can see a gate to the west, the Rocky Field to the east and a pathway leading to the south.

You can see Gate, Landon and Daisy here.

>talk
(to Landon)
"If there's something you want to ask me, go for it."

>unlock gate with keycard
You need to "input a four digit code into the Digital Lock". There's a hint below saying "the last four digits". If I thought the password maker was a minimalist, I might "input 1111 into the Digital Lock".

>input 2302
You hear a wonderful chiming sound as the screen fades to black and the Digital Lock opens .

>w
(first opening Gate)
As soon as you open the gate, Landon runs off into the distance without even a goodbye.

Street
Finally we've reached civilization. Maybe my phone actually gets reception here.

You can see Gate here.

>call mom
After discovering you finally have a phone signal, you decide to call "Mom". After a few rings you hear a frantic voice.
"Catherine, is that you? I've been worried sick."
"Um… you are my mom right? It might be hard to believe it but I lost my…鎟㈐㌯㊰㌯㑀㌯酀鎟""So how is your case going. You promised to come over for dinner at six but…⁥敢湥眠牯楲摥猠捩⹫ਢ""㡋"""My case…?seri hca㌯㊰"
"Yeah, Detective Jowd put you on the case to catch the prime suspect in the February Killings. What was his name again? Meyers something… Brandon maybe?㡋"

    *** And so you continue your life looking for the elusive Brandon, alleged murderer in the February Killings and the one who stole your memories. ***

In that game you scored 0 out of a possible 0, in 23 turns.

Would you like to RESTART, RESTORE a saved game, QUIT or UNDO the last command?

* * *

>pick up cell phone
Taken.

>go south
You can't go that way.

>go west
Grassy Meadow
Patches of grass and wildflowers fill the meadow. It's surrounded by a rather tall fence. You can see a gate to the west, the Rocky Field to the east and a pathway leading to the south.

You can see Gate and Daisy here.

>inspect daisy
That's not a verb I recognise.

>look at daisy
A cute white daisy. This flower looked a little lonely so I just had to pick him up.

>take daisy
Taken.

>i
You are carrying:
  Daisy
  Cell Phone

>take gate
That's fixed in place.

>look at gate
You see nothing special about Gate.

>go to gate
You can't see any such thing.

>go west
(first opening Gate)
It seems to be locked.

>go east
Rocky Field
A dirt covered field with rocks scattered about. A dark shadow casts itself over much of the field. You can see a Pine Tree Trail to the north and a Grassy Meadow to the west.

>go north
Pine Tree Trail
A fairly normal hiking trail full of pine trees.  You can see the a Rocky Field to the south, a Forest Clearing to the northeast and a Bridge to the east.

>go northeast
Forest Clearing
Sunlight filters through the leaves of the trees above. You can see the Pine Tree Trail to the southwest and a Waterfall to the southeast.

You can see Stranger here.

>run away
You can't see any such thing.

>go southwest
Pine Tree Trail
A fairly normal hiking trail full of pine trees.  You can see the a Rocky Field to the south, a Forest Clearing to the northeast and a Bridge to the east.

>go east
Bridge
A rope bridge built atop a flowing river. It occasionally sways from side to side making you question its architectural integrity. You wouldn't be able to damage the bridge with your bare hands, but with the right tools, who knows what you could do. You can see a Pine Tree Trail to the west, and a Waterfall to the east.

>go east
Waterfall
A huge waterfall roars above. You can see the Bridge to the west and the Forest Clearing to the northwest.

You can see Telescope here.

>take telescope
Taken.

>go west
Bridge
A rope bridge built atop a flowing river. It occasionally sways from side to side making you question its architectural integrity. You wouldn't be able to damage the bridge with your bare hands, but with the right tools, who knows what you could do. You can see a Pine Tree Trail to the west, and a Waterfall to the east.

>go west
Pine Tree Trail
A fairly normal hiking trail full of pine trees.  You can see the a Rocky Field to the south, a Forest Clearing to the northeast and a Bridge to the east.

>go south
Rocky Field
A dirt covered field with rocks scattered about. A dark shadow casts itself over much of the field. You can see a Pine Tree Trail to the north and a Grassy Meadow to the west.

>go west
Grassy Meadow
Patches of grass and wildflowers fill the meadow. It's surrounded by a rather tall fence. You can see a gate to the west, the Rocky Field to the east and a pathway leading to the south.

You can see Gate here.

>go south
Cliff
A sheer cliff overlooking the Rocky Field. The Grassy Meadow is to the north.

>look at cell phone
An ordinary picture phone that just might be mine. Maybe if I rummage through the pictures or contact information, I'll be able to find out who I am. I should "select Photo Menu" or "select Contacts Menu".

>select photo menu
From here you can view the phone's photo collection. You can use the commands "next photo" and "previous photo" to browse through the photos.

In Photo Menu are Photo 1, Photo 2 and Photo 3.

>next photo
(Cell Phone)

>photo 1
That's not a verb I recognise.

>next photo
(Cell Phone)

>look at photo 1
It's a picture of a house. It's a modern one story model with solar panels and everything. Behind it there's a gate surrounded by a grassy field.

>go to gate
You can't see any such thing.

>next photo
(Cell Phone)
It's a picture of a woman with brown hair in a ponytail. She's wearing a navy blue coat and is carrying a rather large backpack. She's standing in front of a gate.

>next photo
(Cell Phone)
It's a picture of a young man doing something next to a rather plain looking bush. There are many pine trees in the background.

>go north
Grassy Meadow
Patches of grass and wildflowers fill the meadow. It's surrounded by a rather tall fence. You can see a gate to the west, the Rocky Field to the east and a pathway leading to the south.

You can see Gate here.

>go east
Rocky Field
A dirt covered field with rocks scattered about. A dark shadow casts itself over much of the field. You can see a Pine Tree Trail to the north and a Grassy Meadow to the west.

>go north
Pine Tree Trail
A fairly normal hiking trail full of pine trees.  You can see the a Rocky Field to the south, a Forest Clearing to the northeast and a Bridge to the east. At a closer glance you can see the bush from the photo.

>look at bush
A rather plain looking bush. You can see a large metalic thing under the bush.

>take metalic thing
Taken.

>i
You are carrying:
  Saw
  Telescope
  Daisy
  Cell Phone

>go northeast
Forest Clearing
Sunlight filters through the leaves of the trees above. You can see the Pine Tree Trail to the southwest and a Waterfall to the southeast.

You can see Stranger here.

>look at stranger
A young familiar looking black haired man.

>show stranger saw
Stranger is unimpressed.

>show stranger cell phone
Stranger is unimpressed.

>impress stranger
That's not a verb I recognise.

>talk to stranger
"Shoots it's her" Stranger mutters before running towards the Pine Tree Trail.

>stop stranger
That's not a verb I recognise.

>look at clearing
You can't see any such thing.

>look
Forest Clearing
Sunlight filters through the leaves of the trees above. You can see the Pine Tree Trail to the southwest and a Waterfall to the southeast.

>examine trees
Beautiful pine trees line the trail. I wonder if squirels live in them.

>examine for squirels
You can't see any such thing.

>go south east
I only understood you as far as wanting to go south.

>go southeast
Waterfall
A huge waterfall roars above. You can see the Bridge to the west and the Forest Clearing to the northwest.

>go west
Bridge
A rope bridge built atop a flowing river. It occasionally sways from side to side making you question its architectural integrity. You wouldn't be able to damage the bridge with your bare hands, but with the right tools, who knows what you could do. You can see a Pine Tree Trail to the west, and a Waterfall to the east.

>damage bridge
That's not a verb I recognise.

>use saw on bridge
That's not a verb I recognise.

>cut bridge
You walk right off of the easternmost side of the bridge. You cut the rope supports of the bridge and the wodden rope structure falls to the other side of the ravine. Now there's a vast gap in the bridge's place.

Waterfall
A huge waterfall roars above. You can see the Bridge to the west and the Forest Clearing to the northwest.

>go northwest
Forest Clearing
Sunlight filters through the leaves of the trees above. You can see the Pine Tree Trail to the southwest and a Waterfall to the southeast.

You can see Stranger here.

>go southwest
Pine Tree Trail
A fairly normal hiking trail full of pine trees.  You can see the a Rocky Field to the south, a Forest Clearing to the northeast and a Bridge to the east. At a closer glance you can see the bush from the photo.

>go northeast
Forest Clearing
Sunlight filters through the leaves of the trees above. You can see the Pine Tree Trail to the southwest and a Waterfall to the southeast.

You can see Stranger here.

>talk to stranger
"Shoots it's her" Stranger mutters before running southwest towards the Pine Tree Trail.

>go southwest
Pine Tree Trail
A fairly normal hiking trail full of pine trees.  You can see the a Rocky Field to the south, a Forest Clearing to the northeast and a Bridge to the east. At a closer glance you can see the bush from the photo. 

You can see Stranger here.

>talk to stanger
You can't see any such thing.

>talk to stranger
Stranger gawks at the broken bridge and runs south towards the Rocky Field instead.

>go wouth
You can't see any such thing.

>go south
Rocky Field
A dirt covered field with rocks scattered about. A dark shadow casts itself over much of the field. You can see a Pine Tree Trail to the north and a Grassy Meadow to the west.

You can see Stranger here.

>talk to stranger
"You're a persistant one" Stranger mutters as he sprints west towards the Grassy Meadow.

>go west
Grassy Meadow
Patches of grass and wildflowers fill the meadow. It's surrounded by a rather tall fence. You can see a gate to the west, the Rocky Field to the east and a pathway leading to the south.

You can see Gate and Stranger here.

>talk to stranger
"You're a persistant one" Stranger mutters as he sprints towards the southern path.

>go south
Cliff
A sheer cliff overlooking the Rocky Field. The Grassy Meadow is to the north.

You can see Stranger here.

>talk to stranger
After taking a look around, the Stranger sees that there is no where to run and resigns himself to his fate.
 "What are the chances that we'd end up here" he mutters to himself as you walk towards him.
"Who are you?" you ask.
"What?!?"
"I swear, I never even met you but you keep on running away."
    "…"        "I think I lost my memory but for some reason I have pictures of you in my phone. Do you have any idea about who I am?"        "I see… You are not someone I know personally I am not against cooperating with you to get out of this place."    You agree to cooperate with the stranger.
"By the way, my name is Landon, Landon Meyers."

>nickname him lemon
That's not a verb I recognise.

>talk to landon
Landon shuffles with the backpack he's wearing and passes you a keycard. "This activates something in the gate, but doesn't open it" he says.

>talk to landon
"If there's something you want to ask me, go for it."

>ask landon
What do you want to ask Landon for?

>ask landon for water
You can't see any such thing.

>ask landon about memories
There is no reply.

>ask landon about where we are
There is no reply.

>ask landon about the situation
There is no reply.

>ask landon what he knows
I didn't understand that sentence.

>look
Cliff
A sheer cliff overlooking the Rocky Field. The Grassy Meadow is to the north.

You can see Landon here.

>go north
Grassy Meadow
Patches of grass and wildflowers fill the meadow. It's surrounded by a rather tall fence. You can see a gate to the west, the Rocky Field to the east and a pathway leading to the south.

You can see Gate and Landon here.

>go west
(first opening Gate)
It seems to be locked.

>i
You are carrying:
  Keycard
  Saw
  Telescope
  Daisy
  Cell Phone

>use keycar
That's not a verb I recognise.

>use keycard
That's not a verb I recognise.

>unlock gate
What do you want to unlock Gate with?

>keycard
You need to "input a four digit code into the Digital Lock". There's a hint below saying "the last four digits". If I thought the password maker was a minimalist, I might "input 1111 into the Digital Lock".

* * *

>look at cell phone
An ordinary picture phone that just might be mine. Maybe if I rummage through the pictures or contact information, I'll be able to find out who I am. I should "select Photo Menu" or "select Contacts Menu".

>select contacs menu
You can't see any such thing.

>'select contacts menu
That's not a verb I recognise.

>select contacts menu
From here you can view your phone's contacts.

In Contacts Menu are My Number and Mom's Number.

>my number
That's not a verb I recognise.

>look at my number
4442302

>look at mom's number
3588970

>ask landon why he sucks
I didn't understand that sentence.

>ask landon about his sob story
There is no reply.

>ask landon about himself
"My past is none of your business. Just because we we're working together doesn't mean we're friends or anything.
You think you've bonded with Landon.

>ask landon about his friends
There is no reply.

>ask landon about his girlfriend
There is no reply.

>ask landon about yourself
There is no reply.

>ask landon about me
"You want me to tell you about yourself? I can't tell you much other than physical appearance though. Twentyish, brown haired with a ponytail. You look pretty average too me. Hey? Why are you looking at me like that?"
You think you've bonded with Landon.

>input 2302
You hear a wonderful chiming sound as the screen fades to black and the Digital Lock opens .

>open gate
As soon as you open the gate, Landon runs off into the distance without even a goodbye.

>you suck landon
That's not a verb I recognise.

>chase landon
That's not a verb I recognise.

>go west after that $%^&(O landon
I only understood you as far as wanting to go west.

>go west
Street
Finally we've reached civilization. Maybe my phone actually gets reception here.

You can see Gate here.

>look at phone
An ordinary picture phone that just might be mine. Maybe if I rummage through the pictures or contact information, I'll be able to find out who I am. I should "select Photo Menu" or "select Contacts Menu".

>call 4442302
I can't call myself.

>call 3588970
After discovering you finally have a phone signal, you decide to call "Mom". After a few rings you hear a frantic voice.
"Catherine, is that you? I've been worried sick."
"Um… you are my mom right? It might be hard to believe it but I lost my…""So how is your case going. You promised to come over for dinner at six but…""My case…?"
"Yeah, Detective Jowd put you on the case to catch the prime suspect in the February Killings. What was his name again? Meyers something… Brandon maybe?"

    *** And so you continue your life looking for the elusive Brandon, alleged murderer in the February Killings and the one who stole your memories. (If you choose to play the game again, try interacting with Landon more) ***

In that game you scored 0 out of a possible 0, in 83 turns.

Would you like to RESTART, RESTORE a saved game, QUIT or UNDO the last command?

* * *

>pick up cell phone
Taken.

>look at cellphone
An ordinary picture phone that just might be mine. Maybe if I rummage through the pictures or contact information, I'll be able to find out who I am. I should "select Photo Menu" or "select Contacts Menu".

>select photo menu
From here you can view the phone's photo collection. You can use the commands "next photo" and "previous photo" to browse through the photos.

In Photo Menu are Photo 1, Photo 2 and Photo 3.

>photo 1
That's not a verb I recognise.

>look at photo 1
It's a picture of a house. It's a modern one story model with solar panels and everything. Behind it there's a gate surrounded by a grassy field.

>look at photo 2
A picture of a woman with brown hair in a ponytail. She's wearing a navy blue coat and is carrying a large green backpack. She's standing in front of a gate.

>look at photo 3
It's a picture of a young black haired man doing something next to a rather plain looking bush. There are many pine trees in the background.

>select contacts menu
From here you can view your phone's contacts.

In Contacts Menu are My Number and Mom's Number.

>look at my number
4442302

>look around
You can't see any such thing.

>go to grassy meadow
You can't see any such thing.

>go to pine tree
You can't see any such thing.

>go north
Pine Tree Trail
A fairly normal hiking trail full of pine trees.  You can see the a Rocky Field to the south, a Forest Clearing to the northeast and a Bridge to the east. At a closer glance you can see the bush from the photo.

>go south
Rocky Field
A dirt covered field with rocks scattered about. A high cliff looms above casting a shadow over much of the field. You can see a Pine Tree Trail to the north and a Grassy Meadow to the west.

>go west
Grassy Meadow
Patches of grass and wildflowers fill the meadow. It's surrounded by a rather tall fence. You can see a gate to the west, the Rocky Field to the east and a pathway leading to the south.

You can see Gate and Daisy here.

>pick up daisy
Taken.

>go east
Rocky Field
A dirt covered field with rocks scattered about. A high cliff looms above casting a shadow over much of the field. You can see a Pine Tree Trail to the north and a Grassy Meadow to the west.

>so north
That's not a verb I recognise.

>go north
Pine Tree Trail
A fairly normal hiking trail full of pine trees.  You can see the a Rocky Field to the south, a Forest Clearing to the northeast and a Bridge to the east. At a closer glance you can see the bush from the photo.

>go northeast
Forest Clearing
Sunlight filters through the leaves of the trees above. You can see the Pine Tree Trail to the southwest and a Waterfall to the southeast.

You can see Stranger here.

>talk to stranger
"Shoots it's her" Stranger mutters before running towards the Pine Tree Trail.

>go southwest
Pine Tree Trail
A fairly normal hiking trail full of pine trees.  You can see the a Rocky Field to the south, a Forest Clearing to the northeast and a Bridge to the east. At a closer glance you can see the bush from the photo. 

You can see Stranger here.

>talk to stranger
"Shoots it's her" Stranger mutters before running towards the Bridge.

>go east
Bridge
A rope bridge built atop a flowing river. It occasionally sways from side to side making you question its architectural integrity. You can see a Pine Tree Trail to the west, and a Waterfall to the east.

You can see Stranger here.

>talk to stranger
"Shoots it's her" Stranger mutters before running towards the Waterfall.

>go east
Waterfall
A huge waterfall roars above. You can see the Bridge to the west and the Forest Clearing to the northwest.

You can see Stranger and Telescope here.

>pick up telescope
Taken.

>talk to stranger
"Shoots it's her" Stranger mutters before running towards the Forest Clearing.

>go northeast
You can't go that way.

>go northwest
Forest Clearing
Sunlight filters through the leaves of the trees above. You can see the Pine Tree Trail to the southwest and a Waterfall to the southeast.

You can see Stranger here.

>talk to stranger
"Shoots it's her" Stranger mutters before running towards the Pine Tree Trail.

* * *

>go southwest
Pine Tree Trail
A fairly normal hiking trail full of pine trees.  You can see the a Rocky Field to the south, a Forest Clearing to the northeast and a Bridge to the east. At a closer glance you can see the bush from the photo. 

You can see Stranger here.

>go east
Bridge
A rope bridge built atop a flowing river. It occasionally sways from side to side making you question its architectural integrity. You can see a Pine Tree Trail to the west, and a Waterfall to the east.

>go east
Waterfall
A huge waterfall roars above. You can see the Bridge to the west and the Forest Clearing to the northwest.

>look at telescope
A telescope pointed towards nearby scenery. It's so detailed you can see individual leaves on trees.

>go northwest
Forest Clearing
Sunlight filters through the leaves of the trees above. You can see the Pine Tree Trail to the southwest and a Waterfall to the southeast.

>go southwest
Pine Tree Trail
A fairly normal hiking trail full of pine trees.  You can see the a Rocky Field to the south, a Forest Clearing to the northeast and a Bridge to the east. At a closer glance you can see the bush from the photo. 

You can see Stranger here.

* * *

>talk to stranger
"Shoots it's her" Stranger mutters before running towards the Bridge.

>go south
Rocky Field
A dirt covered field with rocks scattered about. A high cliff looms above casting a shadow over much of the field. You can see a Pine Tree Trail to the north and a Grassy Meadow to the west.

>go west
Grassy Meadow
Patches of grass and wildflowers fill the meadow. It's surrounded by a rather tall fence. You can see a gate to the west, the Rocky Field to the east and a pathway leading to the south.

You can see Gate here.

>go to gate
You can't see any such thing.

* * *

>go west
(first opening Gate)
It seems to be locked.

>go osuth
You can't see any such thing.

>go south
Cliff
A sheer cliff overlooking the Rocky Field. The Grassy Meadow is to the north.

>look telescope
A telescope pointed towards nearby scenery. It's so detailed you can see individual leaves on trees.

>use telescope
That's not a verb I recognise.

* * *

>take cell
Taken.

* * *

>take cellphone
Taken.

>take Cell Phone
Taken.

>examine phone
An ordinary picture phone that just might be mine. Maybe if I rummage through the pictures or contact information, I'll be able to find out who I am. I should "select Photo Menu" or "select Contacts Menu".

>select Photo Menu
From here you can view the phone's photo collection. You can use the commands "next photo" and "previous photo" to browse through the photos.

In Photo Menu are Photo 1, Photo 2 and Photo 3.

>photo 1
That's not a verb I recognise.

* * *

>next photo
(Cell Phone)

>examine
(Cell Phone)
An ordinary picture phone that just might be mine. Maybe if I rummage through the pictures or contact information, I'll be able to find out who I am. I should "select Photo Menu" or "select Contacts Menu".

>examine photo 1
It's a picture of a house. It's a modern one story model with solar panels and everything. Behind it there's a gate surrounded by a grassy field.

>next photo
(Cell Phone)
It's a picture of a woman with brown hair in a ponytail. She's wearing a navy blue coat and is carrying a rather large backpack. She's standing in front of a gate.

* * *

>next photo
(Cell Phone)
It's a picture of a young man doing something next to a rather plain looking bush. There are many pine trees in the background.

>contacts
That's not a verb I recognise.

>select contact menu
You can't see any such thing.

>examin
That's not a verb I recognise.

>examine
(Cell Phone)
An ordinary picture phone that just might be mine. Maybe if I rummage through the pictures or contact information, I'll be able to find out who I am. I should "select Photo Menu" or "select Contacts Menu".

>select contact menu
You can't see any such thing.

>read
(Cell Phone)
An ordinary picture phone that just might be mine. Maybe if I rummage through the pictures or contact information, I'll be able to find out who I am. I should "select Photo Menu" or "select Contacts Menu".

>select contacts menu
From here you can view your phone's contacts.

In Contacts Menu are My Number and Mom's Number.

>call mom
Someone in my contacts list called "Mom" should know about me right? I try calling, but it appears that I'm out of range. Maybe if I could get to civilization…pe Is that

>call self
Someone in my contacts list called "Mom" should know about me right? I try calling, but it appears that I'm out of range. Maybe if I could get to civilization…pears that

>go west
Grassy Meadow
Patches of grass and wildflowers fill the meadow. It's surrounded by a rather tall fence. You can see a gate to the west, the Rocky Field to the east and a pathway leading to the south.

You can see Gate and Daisy here.

>take daisy
Taken.

>go south
Cliff
A sheer cliff overlooking the Rocky Field. The Grassy Meadow is to the north.

>go north
Grassy Meadow
Patches of grass and wildflowers fill the meadow. It's surrounded by a rather tall fence. You can see a gate to the west, the Rocky Field to the east and a pathway leading to the south.

You can see Gate here.

>open gate
It seems to be locked.

>go over gate
You can't see any such thing.

>go east
Rocky Field
A dirt covered field with rocks scattered about. A high cliff looms above casting a shadow over much of the field. You can see a Pine Tree Trail to the north and a Grassy Meadow to the west.

>go north
Pine Tree Trail
A fairly normal hiking trail full of pine trees.  You can see the a Rocky Field to the south, a Forest Clearing to the northeast and a Bridge to the east. At a closer glance you can see the bush from the photo.

>examine
What do you want to examine?

>examine bush
A rather plain looking bush. You can see a large metalic thing under the bush.

>examine
What do you want to examine?

* * *

>examine bush
A rather plain looking bush. You can see a large metalic thing under the bush.

>examine metalic thing under the bush
I only understood you as far as wanting to examine Saw.

>take
What do you want to take?

>examine bush
A rather plain looking bush. You can see a large metalic thing under the bush.

>take metalic thing under the bush
I only understood you as far as wanting to take Saw.

>take saw
Taken.

>cut off arms
You can't see any such thing.

>saw off legs
That's not a verb I recognise.

>look
Pine Tree Trail
A fairly normal hiking trail full of pine trees.  You can see the a Rocky Field to the south, a Forest Clearing to the northeast and a Bridge to the east. At a closer glance you can see the bush from the photo.

>go east
Bridge
A rope bridge built atop a flowing river. It occasionally sways from side to side making you question its architectural integrity. You can see a Pine Tree Trail to the west, and a Waterfall to the east.

>saw bridge
That's not a verb I recognise.

>cut rope
You walk right off of the easternmost side of the bridge. You cut the rope supports of the bridge and the wodden rope structure falls to the other side of the ravine. Now there's a vast gap in the bridge's place.

Waterfall
A huge waterfall roars above. You can see the Bridge to the west and the Forest Clearing to the northwest.

You can see Telescope here.

>take telescope
Taken.

>go west
Without the bridge it's impossible to cross.

>go northwest
Forest Clearing
Sunlight filters through the leaves of the trees above. You can see the Pine Tree Trail to the southwest and a Waterfall to the southeast.

You can see Stranger here.

* * *

>go southwest
Pine Tree Trail
A fairly normal hiking trail full of pine trees.  You can see the a Rocky Field to the south, a Forest Clearing to the northeast and a Bridge to the east. At a closer glance you can see the bush from the photo. 

You can see Stranger here.

>talk to stranger
Stranger gawks at the broken bridge and runs towards the Rocky Field instead.

>go south
Rocky Field
A dirt covered field with rocks scattered about. A high cliff looms above casting a shadow over much of the field. You can see a Pine Tree Trail to the north and a Grassy Meadow to the west.

You can see Stranger here.

>talk to stranger
"You're a persistant one" Stranger mutters as he sprints towards the grassy meadow.

>go west
Grassy Meadow
Patches of grass and wildflowers fill the meadow. It's surrounded by a rather tall fence. You can see a gate to the west, the Rocky Field to the east and a pathway leading to the south.

You can see Gate and Stranger here.

* * *

>go south
Cliff
A sheer cliff overlooking the Rocky Field. The Grassy Meadow is to the north.

You can see Stranger here.

>talk to stranger
After taking a look around, the Stranger sees that there is no where to run and resigns himself to his fate.
 "What are the chances that we'd end up here" he mutters to himself as you walk towards him.
"Who are you?" you ask.
"What?!?"
"I swear, I never even met you but you keep on running away."
    "…"        "I think I lost my memory but for some reason I have pictures of you in my phone. Do you have any idea about who I am?"        "I see… You are not someone I know personally I am not against cooperating with you to get out of this place.敶⁵畢⁴潹휫덍\皐㡃"    You agree to cooperate with the stranger.
"By the way, my name is Landon, Landon Meyers."

>kill landon
Violence isn't the answer to this one.

>use telescope
That's not a verb I recognise.

>look through telescope
You find nothing of interest.

>i
You are carrying:
  Telescope
  Saw
  Daisy
  Cell Phone

>give Landon Daisy
"For me? I'm not a girl you know but… thanks.　ŀƤ\碠㡃퉅鍍턞
You think you've bonded with Landon.

>give landon telescope
Landon doesn't seem interested.

>talk
(to Landon)
Landon shuffles with the backpack he's wearing and passes you a keycard. "This activates something in the gate, but doesn't open it" he says.

>go west
You can't go that way.

>go eas
You can't see any such thing.

>go east
You can't go that way.

>go north
Grassy Meadow
Patches of grass and wildflowers fill the meadow. It's surrounded by a rather tall fence. You can see a gate to the west, the Rocky Field to the east and a pathway leading to the south.

You can see Gate and Landon here.

>open gate
It seems to be locked.

>use key
That's not a verb I recognise.

>unlock gate
What do you want to unlock Gate with?

>unlock gate with key
You can't see any such thing.

>unlock gate with keycard
You need to "input a four digit code into the Digital Lock". There's a hint below saying "the last four digits". If I thought the password maker was a minimalist, I might "input 1111 into the Digital Lock".

>examine phone
An ordinary picture phone that just might be mine. Maybe if I rummage through the pictures or contact information, I'll be able to find out who I am. I should "select Photo Menu" or "select Contacts Menu".

>select contacts menu
From here you can view your phone's contacts.

In Contacts Menu are My Number and Mom's Number.

>select my number
4442302

* * *

I beg your pardon?

>input 2302
You hear a wonderful chiming sound as the screen fades to black and the Digital Lock opens .

>enter
You must supply a noun.

>enter place
You can't see any such thing.

>go west
(first opening Gate)
As soon as you open the gate, Landon runs off into the distance without even a goodbye.

Street
Finally we've reached civilization. Maybe my phone actually gets reception here.

You can see Gate here.

* * *

>hack the phone
That's not a verb I recognise.

>blow it up
That's not a verb I recognise.

>take the f******n phone!!!!
You can't see any such thing.

>take the phone
Taken.

>go west
Grassy Meadow
Patches of grass and wildflowers fill the meadow. It's surrounded by a rather tall fence. You can see a gate to the west, the Rocky Field to the east and a pathway leading to the south.

You can see Gate and Daisy here.

>go to the gate
You can't see any such thing.

>but i can see a gate
That's not a verb I recognise.

>go to gate
You can't see any such thing.

>open gate
It seems to be locked.

>break it down
I only understood you as far as wanting to break Gate.

>jump the fence
I only understood you as far as wanting to jump.

>go around the fence
You can't see any such thing.

>go back
You can't see any such thing.

>make an immediate pi/2 radian turn clockwise
That's not a verb I recognise.

>go north
You can't go that way.

>go west
(first opening Gate)
It seems to be locked.

>go south
Cliff
A sheer cliff overlooking the Rocky Field. The Grassy Meadow is to the north.

>JUMP
You jump on the spot, fruitlessly.

>go north
Grassy Meadow
Patches of grass and wildflowers fill the meadow. It's surrounded by a rather tall fence. You can see a gate to the west, the Rocky Field to the east and a pathway leading to the south.

You can see Gate and Daisy here.

>go west
(first opening Gate)
It seems to be locked.

>go to meadow
You can't see any such thing.

>go east
Rocky Field
A dirt covered field with rocks scattered about. A high cliff looms above casting a shadow over much of the field. You can see a Pine Tree Trail to the north and a Grassy Meadow to the west.

>go north
Pine Tree Trail
A fairly normal hiking trail full of pine trees.  You can see the a Rocky Field to the south, a Forest Clearing to the northeast and a Bridge to the east.

>go east
Bridge
A rope bridge built atop a flowing river. It occasionally sways from side to side making you question its architectural integrity. You can see a Pine Tree Trail to the west, and a Waterfall to the east.

>analyze its structural integrity
That's not a verb I recognise.

>go east
Waterfall
A huge waterfall roars above. You can see the Bridge to the west and the Forest Clearing to the northwest.

You can see Telescope here.

>loot through telescope
That's not a verb I recognise.

>look through telescope
You find nothing of interest.

>calculate focal distance from the lense using optical physics and set the meadow on fire
That's not a verb I recognise.

>go west
Bridge
A rope bridge built atop a flowing river. It occasionally sways from side to side making you question its architectural integrity. You can see a Pine Tree Trail to the west, and a Waterfall to the east.

>cross bridge
That's not something you can enter.

>go east
Waterfall
A huge waterfall roars above. You can see the Bridge to the west and the Forest Clearing to the northwest.

You can see Telescope here.

>go northwest
Forest Clearing
Sunlight filters through the leaves of the trees above. You can see the Pine Tree Trail to the southwest and a Waterfall to the southeast.

You can see Stranger here.

* * *

>talk to stranger
"Shoots it's her" Stranger mutters before running towards the Pine Tree Trail.

>go southeast
Waterfall
A huge waterfall roars above. You can see the Bridge to the west and the Forest Clearing to the northwest.

You can see Telescope here.

>go northeast
You can't go that way.

>go northwest
Forest Clearing
Sunlight filters through the leaves of the trees above. You can see the Pine Tree Trail to the southwest and a Waterfall to the southeast.

>go southwest
Pine Tree Trail
A fairly normal hiking trail full of pine trees.  You can see the a Rocky Field to the south, a Forest Clearing to the northeast and a Bridge to the east.  

You can see Stranger here.

>talk to stranger
"Shoots it's her" Stranger mutters before running towards the Bridge.

* * *

>talk to stranger
"Shoots it's her" Stranger mutters before running towards the Waterfall.

>go to east
You can't see any such thing.

>go east
Waterfall
A huge waterfall roars above. You can see the Bridge to the west and the Forest Clearing to the northwest.

You can see Stranger and Telescope here.

>BEAT HIM WITH TEH TELESCOPE!!!!
That's not a verb I recognise.

>talk to stranger
"Shoots it's her" Stranger mutters before running towards the Forest Clearing.

>go northwest
Forest Clearing
Sunlight filters through the leaves of the trees above. You can see the Pine Tree Trail to the southwest and a Waterfall to the southeast.

You can see Stranger here.

>stare amorously at stranger
That's not a verb I recognise.

>kiss stranger
Keep your mind on the game.

>strip
That's not a verb I recognise.

>i
You are carrying:
  Cell Phone

>throw phone at stranger
You lack the nerve when it comes to the crucial moment.

>talk to stranger
"Shoots it's her" Stranger mutters before running towards the Pine Tree Trail.

>go to pine tree trail
You can't see any such thing.

>go southeast
Waterfall
A huge waterfall roars above. You can see the Bridge to the west and the Forest Clearing to the northwest.

You can see Telescope here.

>look at telescope
A telescope pointed towards nearby scenery. It's so detailed you can see individual leaves on trees.

* * *

>go southwest
Pine Tree Trail
A fairly normal hiking trail full of pine trees.  You can see the a Rocky Field to the south, a Forest Clearing to the northeast and a Bridge to the east.  

You can see Stranger here.

>look at stranger
A young black haired man.

>go to trail
You can't see any such thing.

>talk to stranger
"Shoots it's her" Stranger mutters before running towards the Bridge.

* * *

>go south
Rocky Field
A dirt covered field with rocks scattered about. A high cliff looms above casting a shadow over much of the field. You can see a Pine Tree Trail to the north and a Grassy Meadow to the west.

>kill yourself with the phone
I only understood you as far as wanting to kill yourself.

>look at phone
An ordinary picture phone that just might be mine. Maybe if I rummage through the pictures or contact information, I'll be able to find out who I am. I should "select Photo Menu" or "select Contacts Menu".

>select photo menu
From here you can view the phone's photo collection. You can use the commands "next photo" and "previous photo" to browse through the photos.

In Photo Menu are Photo 1, Photo 2 and Photo 3.

* * *

>look at photo 3
It's a picture of a young black haired man doing something next to a rather plain looking bush. There are many pine trees in the background.

>look at contacts menu
From here you can view your phone's contacts.

In Contacts Menu are My Number and Mom's Number.

>call mom
Someone in my contacts list called "Mom" should know about me right? I try calling, but it appears that I'm out of range. Maybe if I could get to civilization…pears th

>go to civilization
You can't see any such thing.

>call my number
I can't call myself.

>crack open the phone and organ harvest for various electronic components to build a rocket and get out of this god forsaken place
You can't see any such thing.

>go north
Pine Tree Trail
A fairly normal hiking trail full of pine trees.  You can see the a Rocky Field to the south, a Forest Clearing to the northeast and a Bridge to the east. At a closer glance you can see the bush from the photo.

* * *

>take metalic thing
Taken.

>look at metalic thing
It's a large metal saw that looks useful for cutting

>go south
Rocky Field
A dirt covered field with rocks scattered about. A high cliff looms above casting a shadow over much of the field. You can see a Pine Tree Trail to the north and a Grassy Meadow to the west.

* * *

>go west
Grassy Meadow
Patches of grass and wildflowers fill the meadow. It's surrounded by a rather tall fence. You can see a gate to the west, the Rocky Field to the east and a pathway leading to the south.

You can see Gate and Daisy here.

>go to gate
You can't see any such thing.

* * *

>go west
(first opening Gate)
It seems to be locked.

>go east
Rocky Field
A dirt covered field with rocks scattered about. A high cliff looms above casting a shadow over much of the field. You can see a Pine Tree Trail to the north and a Grassy Meadow to the west.

>go west
Grassy Meadow
Patches of grass and wildflowers fill the meadow. It's surrounded by a rather tall fence. You can see a gate to the west, the Rocky Field to the east and a pathway leading to the south.

You can see Gate and Daisy here.

>go south
Cliff
A sheer cliff overlooking the Rocky Field. The Grassy Meadow is to the north.

>rapel down the cliff
That's not a verb I recognise.

>climb down the cliff
I only understood you as far as wanting to climb down.

>scale the cliff
You can't see any such thing.

>go north
Grassy Meadow
Patches of grass and wildflowers fill the meadow. It's surrounded by a rather tall fence. You can see a gate to the west, the Rocky Field to the east and a pathway leading to the south.

You can see Gate and Daisy here.

>use saw to cut down fence
That's not a verb I recognise.

>use saw
That's not a verb I recognise.

>i
You are carrying:
  Saw
  Cell Phone

>go east
Rocky Field
A dirt covered field with rocks scattered about. A high cliff looms above casting a shadow over much of the field. You can see a Pine Tree Trail to the north and a Grassy Meadow to the west.

* * *

>go north
Pine Tree Trail
A fairly normal hiking trail full of pine trees.  You can see the a Rocky Field to the south, a Forest Clearing to the northeast and a Bridge to the east. At a closer glance you can see the bush from the photo.

>go east
Bridge
A rope bridge built atop a flowing river. It occasionally sways from side to side making you question its architectural integrity. You can see a Pine Tree Trail to the west, and a Waterfall to the east.

You can see Stranger here.

>cut down the bridge
I only understood you as far as wanting to cut down.

>cut
What do you want to cut?

>stranger
This seems like a waste of time.

>cut
What do you want to cut?

>bridge
You walk right off of the easternmost side of the bridge. You cut the rope supports of the bridge and the wodden rope structure falls to the other side of the ravine. Now there's a vast gap in the bridge's place.

Waterfall
A huge waterfall roars above. You can see the Bridge to the west and the Forest Clearing to the northwest.

You can see Telescope here.

>go west
Without the bridge it's impossible to cross.

>talk to stranger
You can't see any such thing.

>go west
Without the bridge it's impossible to cross.

* * *

>talk to stranger
"You're a persistant one" Stranger mutters as he sprints towards the grassy meadow.

>go west
Grassy Meadow
Patches of grass and wildflowers fill the meadow. It's surrounded by a rather tall fence. You can see a gate to the west, the Rocky Field to the east and a pathway leading to the south.

You can see Gate, Stranger and Daisy here.

>talk to stranger
"You're a persistant one" Stranger mutters as he sprints towards the southern path.

* * *

>go south
Cliff
A sheer cliff overlooking the Rocky Field. The Grassy Meadow is to the north.

You can see Stranger here.

>talk to stranger
After taking a look around, the Stranger sees that there is no where to run and resigns himself to his fate.
 "What are the chances that we'd end up here" he mutters to himself as you walk towards him.
"Who are you?" you ask.
"What?!?"
"I swear, I never even met you but you keep on running away."
    "…"        "I think I lost my memory but for some reason I have pictures of you in my phone. Do you have any idea about who I am?"        "I see… You are not someone I know personally I am not against cooperating with you to get out of this place.8\껠湮湩⁧睡"    You agree to cooperate with the stranger.
"By the way, my name is Landon, Landon Meyers."

>push stranger off the cliff
You can't see any such thing.

>kill himn
You can't see any such thing.

>throw the phone at him
You can't see "him" (Stranger) at the moment.

>talk to stranger
You can't see any such thing.

>go north
Grassy Meadow
Patches of grass and wildflowers fill the meadow. It's surrounded by a rather tall fence. You can see a gate to the west, the Rocky Field to the east and a pathway leading to the south.

You can see Gate, Landon and Daisy here.

>talk to daisy
You can only do that to something animate.

>take daisy
Taken.

>talk to landon
Landon shuffles with the backpack he's wearing and passes you a keycard. "This activates something in the gate, but doesn't open it" he says.

>go west
(first opening Gate)
It seems to be locked.

>use keycard
That's not a verb I recognise.

>use
That's not a verb I recognise.

>i
You are carrying:
  Keycard
  Daisy
  Saw
  Cell Phone

>open gate
It seems to be locked.

>activate gate
That's not a verb I recognise.

>use keycard
That's not a verb I recognise.

* * *

>keycard
You need to "input a four digit code into the Digital Lock". There's a hint below saying "the last four digits". If I thought the password maker was a minimalist, I might "input 1111 into the Digital Lock".

>look at keycard
You see nothing special about Keycard.

>look at phone
An ordinary picture phone that just might be mine. Maybe if I rummage through the pictures or contact information, I'll be able to find out who I am. I should "select Photo Menu" or "select Contacts Menu".

>select contacts menu
From here you can view your phone's contacts.

In Contacts Menu are My Number and Mom's Number.

>look at moms number
You can't see any such thing.

>unlock gate
What do you want to unlock Gate with?

* * *

>look at phone
An ordinary picture phone that just might be mine. Maybe if I rummage through the pictures or contact information, I'll be able to find out who I am. I should "select Photo Menu" or "select Contacts Menu".

>slect contacts menu
That's not a verb I recognise.

>select contacts menu
From here you can view your phone's contacts.

In Contacts Menu are My Number and Mom's Number.

* * *

>my number
That's not a verb I recognise.

>select my number
4442302

>select mom's number
3588970

>unlock gate
What do you want to unlock Gate with?

* * *

>keycard
You need to "input a four digit code into the Digital Lock". There's a hint below saying "the last four digits". If I thought the password maker was a minimalist, I might "input 1111 into the Digital Lock".

>input 2302 into the Digital Lock
You hear a wonderful chiming sound as the screen fades to black and the Digital Lock opens .

>opne gate
That's not a verb I recognise.

>open gate
As soon as you open the gate, Landon runs off into the distance without even a goodbye.

>follow landon
That's not a verb I recognise.

>follow Landon
That's not a verb I recognise.

>go through gate
Street
Finally we've reached civilization. Maybe my phone actually gets reception here.

You can see Gate here.

>look at phone
An ordinary picture phone that just might be mine. Maybe if I rummage through the pictures or contact information, I'll be able to find out who I am. I should "select Photo Menu" or "select Contacts Menu".

>check phone
An ordinary picture phone that just might be mine. Maybe if I rummage through the pictures or contact information, I'll be able to find out who I am. I should "select Photo Menu" or "select Contacts Menu".

>look around
You can't see any such thing.

>wander around
That's not a verb I recognise.

>call mom
After discovering you finally have a phone signal, you decide to call "Mom". After a few rings you hear a frantic voice.
"Catherine, is that you? I've been worried sick."
"Um… you are my mom right? It might be hard to believe it but I lost my…㓉≈桓潯獴椠❴""So how is your case going. You promised to come over for dinner at six but…⁥敢a good捩⹫ਢ""""My case…?see.mi"
"Yeah, Detective Jowd put you on the case to catch the prime suspect in the February Killings. What was his name again? Meyers something… Brandon maybe?㓉 but"

    *** And so you continue your life looking for the elusive Brandon, alleged murderer in the February Killings and the one who stole your memories. ***

In that game you scored 0 out of a possible 0, in 101 turns.

Would you like to RESTART, RESTORE a saved game, QUIT or UNDO the last command?

>restore
Please supply a filename for restore
(Restore failed, reason: Unable to open file)
Restore failed.

Would you like to RESTART, RESTORE a saved game, QUIT or UNDO the last command?

>undo last command
Please give one of the answers above.

Would you like to RESTART, RESTORE a saved game, QUIT or UNDO the last command?

>undo
Street
[Previous turn undone.]

>Landon
That's not a verb I recognise.

>restart
Are you sure you want to restart?

* * *

>take cell phone
Taken.

>drop cell phone
Dropped.

>take all
You can't use multiple objects with that verb.

* * *

>x me
 You can't remember anything about yourself whether it's your name or how you look. Your head hurts a bit suggesting that your amnesia comes from blunt force trauma.

* * *

>take phone
Taken.

>n
Pine Tree Trail
A fairly normal hiking trail full of pine trees.  You can see the a Rocky Field to the south, a Forest Clearing to the northeast and a Bridge to the east.

>x phone
An ordinary picture phone that just might be mine. Maybe if I rummage through the pictures or contact information, I'll be able to find out who I am. I should "select Photo Menu" or "select Contacts Menu".

>look at photo 2
A picture of a woman with brown hair in a ponytail. She's wearing a navy blue coat and is carrying a large backpack. She's standing in front of a gate.

* * *

>take saw
Taken.

>e
Bridge
A rope bridge built atop a flowing river. It occasionally sways from side to side making you question its architectural integrity. You wouldn't be able to damage the bridge with your bare hands, but with the right tools, who knows what you could do. You can see a Pine Tree Trail to the west, and a Waterfall to the east.

>cut bridge
You walk right off of the easternmost side of the bridge. You cut the rope supports of the bridge and the wodden rope structure falls to the other side of the ravine. Now there's a vast gap in the bridge's place.

Waterfall
A huge waterfall roars above. You can see the Bridge to the west and the Forest Clearing to the northwest.

You can see Telescope here.

* * *

>nw
Forest Clearing
Sunlight filters through the leaves of the trees above. You can see the Pine Tree Trail to the southwest and a Waterfall to the southeast.

You can see Stranger here.

>talk
(to Stranger)
"Shoots it's her" Stranger mutters before running southwest towards the Pine Tree Trail.

>sw
Pine Tree Trail
A fairly normal hiking trail full of pine trees.  You can see the a Rocky Field to the south, a Forest Clearing to the northeast and a Bridge to the east.  

You can see Stranger here.

>talk
(to Stranger)
Stranger gawks at the broken bridge and runs south towards the Rocky Field instead.

>s
Rocky Field
A dirt covered field with rocks scattered about. A dark shadow casts itself over much of the field. You can see a Pine Tree Trail to the north and a Grassy Meadow to the west.

You can see Stranger here.

>talk
(to Stranger)
"You're a persistant one" Stranger mutters as he sprints west towards the Grassy Meadow.

>w
Grassy Meadow
Patches of grass and wildflowers fill the meadow. It's surrounded by a rather tall fence. You can see a gate to the west, the Rocky Field to the east and a pathway leading to the south.

You can see Gate, Stranger and Daisy here.

* * *

>s
Cliff
A sheer cliff overlooking the Rocky Field. The Grassy Meadow is to the north.

You can see Stranger here.

>talk
(to Stranger)
After taking a look around, the Stranger sees that there is no where to run and resigns himself to his fate.
 "What are the chances that we'd end up here" he mutters to himself as you walk towards him.
"Who are you?" you ask.
"What?!?"
"I swear, I never even met you but you keep on running away."
    "…"        "I think I lost my memory but for some reason I have pictures of you in my phone. Do you have any idea about who I am?"        "I see… You are not someone I know personally I am not against cooperating with you to get out of this place.椄整o I am"    You agree to cooperate with the stranger.
"By the way, my name is Landon, Landon Meyers."

>talk
(to Landon)
Landon shuffles with the backpack he's wearing and passes you a keycard. "This activates something in the gate, but doesn't open it" he says.

* * *

>n
Grassy Meadow
Patches of grass and wildflowers fill the meadow. It's surrounded by a rather tall fence. You can see a gate to the west, the Rocky Field to the east and a pathway leading to the south.

You can see Gate, Landon and Daisy here.

>unlock gate with keycard
You need to "input a four digit code into the Digital Lock". There's a hint below saying "the last four digits". If I thought the password maker was a minimalist, I might "input 1111 into the Digital Lock".

>undo
Grassy Meadow
[Previous turn undone.]

>input 2302
You hear a wonderful chiming sound as the screen fades to black and the Digital Lock opens .

>undo
Grassy Meadow
[Previous turn undone.]

>undo
Cliff
[Previous turn undone.]

>n
Grassy Meadow
Patches of grass and wildflowers fill the meadow. It's surrounded by a rather tall fence. You can see a gate to the west, the Rocky Field to the east and a pathway leading to the south.

You can see Gate, Landon and Daisy here.

>input 2302
You hear a wonderful chiming sound as the screen fades to black and the Digital Lock opens .

* * *

>w
(first opening Gate)
As soon as you open the gate, Landon runs off into the distance without even a goodbye.

Street
Finally we've reached civilization. Maybe my phone actually gets reception here.

You can see Gate here.

>call mom
After discovering you finally have a phone signal, you decide to call "Mom". After a few rings you hear a frantic voice.
"Catherine, is that you? I've been worried sick."
"Um… you are my mom right? It might be hard to believe it but I lost my…鎟""So how is your case going. You promised to come over for dinner at six but…⁥敢湥眠牯楲摥猠""My case…?"
"Yeah, Detective Jowd put you on the case to catch the prime suspect in the February Killings. What was his name again? Meyers something… Brandon maybe?t "

    *** And so you continue your life looking for the elusive Brandon, alleged murderer in the February Killings and the one who stole your memories. ***

In that game you scored 0 out of a possible 0, in 20 turns.

Would you like to RESTART, RESTORE a saved game, QUIT or UNDO the last command?

* * *

>e
Bridge
A rope bridge built atop a flowing river. It occasionally sways from side to side making you question its architectural integrity. You wouldn't be able to damage the bridge with your bare hands, but with the right tools, who knows what you could do. You can see a Pine Tree Trail to the west, and a Waterfall to the east.

>cut brindge
You can't see any such thing.

>cut bridge
You walk right off of the easternmost side of the bridge. You cut the rope supports of the bridge and the wodden rope structure falls to the other side of the ravine. Now there's a vast gap in the bridge's place.

Waterfall
A huge waterfall roars above. You can see the Bridge to the west and the Forest Clearing to the northwest.

You can see Telescope here.

* * *

>nw
Forest Clearing
Sunlight filters through the leaves of the trees above. You can see the Pine Tree Trail to the southwest and a Waterfall to the southeast.

You can see Stranger here.

>talk to stranger
"Shoots it's her" Stranger mutters before running towards the Pine Tree Trail.

>sw
Pine Tree Trail
A fairly normal hiking trail full of pine trees.  You can see the a Rocky Field to the south, a Forest Clearing to the northeast and a Bridge to the east.  

You can see Stranger here.

>talk to stranger
Stranger gawks at the broken bridge and runs towards the Rocky Field instead.

>s
Rocky Field
A dirt covered field with rocks scattered about. A high cliff looms above casting a shadow over much of the field. You can see a Pine Tree Trail to the north and a Grassy Meadow to the west.

You can see Stranger here.

>talk to stranger
"You're a persistant one" Stranger mutters as he sprints towards the grassy meadow.

>w
Grassy Meadow
Patches of grass and wildflowers fill the meadow. It's surrounded by a rather tall fence. You can see a gate to the west, the Rocky Field to the east and a pathway leading to the south.

You can see Gate, Stranger and Daisy here.

>talk to stranger
"You're a persistant one" Stranger mutters as he sprints towards the southern path.

>s
Cliff
A sheer cliff overlooking the Rocky Field. The Grassy Meadow is to the north.

You can see Stranger here.

>talk to stranger
After taking a look around, the Stranger sees that there is no where to run and resigns himself to his fate.
 "What are the chances that we'd end up here" he mutters to himself as you walk towards him.
"Who are you?" you ask.
"What?!?"
"I swear, I never even met you but you keep on running away."
    "…"        "I think I lost my memory but for some reason I have pictures of you in my phone. Do you have any idea about who I am?"        "I see… You are not someone I know personally I am not against cooperating with you to get out of this place.漠⁮満㓉敥䜠瑡⁥敨敲ਮ☊瑧;"    You agree to cooperate with the stranger.
"By the way, my name is Landon, Landon Meyers."

>talk to landon
Landon shuffles with the backpack he's wearing and passes you a keycard. "This activates something in the gate, but doesn't open it" he says.

>n
Grassy Meadow
Patches of grass and wildflowers fill the meadow. It's surrounded by a rather tall fence. You can see a gate to the west, the Rocky Field to the east and a pathway leading to the south.

You can see Gate, Landon and Daisy here.

>take daisy
Taken.

>go s
Cliff
A sheer cliff overlooking the Rocky Field. The Grassy Meadow is to the north.

You can see Landon here.

>give daisy to landon
"For me? I'm not a girl you know but… thanks.餀【ﰠ㖉愦潰㭳⁳畳牲畯摮摥戠"
You think you've bonded with Landon.

>undo
Cliff
[Previous turn undone.]

>show daisy to landon
Landon twirls the flower in his hand a bit. "Oh, you want it back, here then."

>give landon daisy
"For me? I'm not a girl you know but… thanks.赠㓎‮瑉愦潰㭳⁳"
You think you've bonded with Landon.

>show telescope to landon
You can't see any such thing.

>i
You are carrying:
  Keycard
  Saw
  Cell Phone

>go w
You can't go that way.

>gon
That's not a verb I recognise.

>n
Grassy Meadow
Patches of grass and wildflowers fill the meadow. It's surrounded by a rather tall fence. You can see a gate to the west, the Rocky Field to the east and a pathway leading to the south.

You can see Gate and Landon here.

>e
Rocky Field
A dirt covered field with rocks scattered about. A high cliff looms above casting a shadow over much of the field. You can see a Pine Tree Trail to the north and a Grassy Meadow to the west.

You can see Landon here.

>w
Grassy Meadow
Patches of grass and wildflowers fill the meadow. It's surrounded by a rather tall fence. You can see a gate to the west, the Rocky Field to the east and a pathway leading to the south.

You can see Gate and Landon here.

>talk to landon
"If there's something you want to ask me, go for it."

>ask
What do you want to ask Landon for?

>clothes
You can't see any such thing.

>ask landon about
I didn't understand that sentence.

>ask landon about clothes
There is no reply.

>ask landon abou gate
I didn't understand that sentence.

>ask landon about gate
There is no reply.

>ask landon about cliff
There is no reply.

>ask landon about self
There is no reply.

* * *

>take phone
Taken.

>i
You are carrying:
  Cell Phone

>look
Rocky Field
A dirt covered field with rocks scattered about. A high cliff looms above casting a shadow over much of the field. You can see a Pine Tree Trail to the north and a Grassy Meadow to the west.

>n
Pine Tree Trail
A fairly normal hiking trail full of pine trees.  You can see the a Rocky Field to the south, a Forest Clearing to the northeast and a Bridge to the east.

>ne
Forest Clearing
Sunlight filters through the leaves of the trees above. You can see the Pine Tree Trail to the southwest and a Waterfall to the southeast.

You can see Stranger here.

>talk
(to Stranger)
"Shoots it's her" Stranger mutters before running towards the Pine Tree Trail.

* * *

>sw
Pine Tree Trail
A fairly normal hiking trail full of pine trees.  You can see the a Rocky Field to the south, a Forest Clearing to the northeast and a Bridge to the east.  

You can see Stranger here.

>talk
(to Stranger)
"Shoots it's her" Stranger mutters before running towards the Bridge.

>ne
Forest Clearing
Sunlight filters through the leaves of the trees above. You can see the Pine Tree Trail to the southwest and a Waterfall to the southeast.

>se
Waterfall
A huge waterfall roars above. You can see the Bridge to the west and the Forest Clearing to the northwest.

You can see Telescope here.

>take
(Telescope)
Taken.

>look
Waterfall
A huge waterfall roars above. You can see the Bridge to the west and the Forest Clearing to the northwest.

>nw
Forest Clearing
Sunlight filters through the leaves of the trees above. You can see the Pine Tree Trail to the southwest and a Waterfall to the southeast.

>se
Waterfall
A huge waterfall roars above. You can see the Bridge to the west and the Forest Clearing to the northwest.

>nw
Forest Clearing
Sunlight filters through the leaves of the trees above. You can see the Pine Tree Trail to the southwest and a Waterfall to the southeast.

>s
You can't go that way.

>sw
Pine Tree Trail
A fairly normal hiking trail full of pine trees.  You can see the a Rocky Field to the south, a Forest Clearing to the northeast and a Bridge to the east.

>ne
Forest Clearing
Sunlight filters through the leaves of the trees above. You can see the Pine Tree Trail to the southwest and a Waterfall to the southeast.

>sw
Pine Tree Trail
A fairly normal hiking trail full of pine trees.  You can see the a Rocky Field to the south, a Forest Clearing to the northeast and a Bridge to the east.

>e
Bridge
A rope bridge built atop a flowing river. It occasionally sways from side to side making you question its architectural integrity. You can see a Pine Tree Trail to the west, and a Waterfall to the east.

You can see Stranger here.

>call
What do you want to call?

>call home
You can't see any such thing.

>look at cellphone
You can't see any such thing.

>look at phone
An ordinary picture phone that just might be mine. Maybe if I rummage through the pictures or contact information, I'll be able to find out who I am. I should "select Photo Menu" or "select Contacts Menu".

* * *

>select photo menu
From here you can view the phone's photo collection. You can use the commands "next photo" and "previous photo" to browse through the photos.

In Photo Menu are Photo 1, Photo 2 and Photo 3.

>1
That's not a verb I recognise.

>look at photo 1
It's a picture of a house. It's a modern one story model with solar panels and everything. Behind it there's a gate surrounded by a grassy field.

>next photo
(Cell Phone)
It's a picture of a woman with brown hair in a ponytail. She's wearing a navy blue coat and is carrying a rather large backpack. She's standing in front of a gate.

>next
What do you want to next?

>next photo
(Cell Phone)
It's a picture of a young man doing something next to a rather plain looking bush. There are many pine trees in the background.

>look at stranger
A young familiar looking black haired man.

>kill stranger
Violence isn't the answer to this one.

>look at telescope
A telescope pointed towards nearby scenery. It's so detailed you can see individual leaves on trees.

>look through telescope
You find nothing of interest.

>talk to stranger
"Shoots it's her" Stranger mutters before running towards the Waterfall.

>e
Waterfall
A huge waterfall roars above. You can see the Bridge to the west and the Forest Clearing to the northwest.

You can see Stranger here.

>talk
(to Stranger)
"Shoots it's her" Stranger mutters before running towards the Forest Clearing.

>look at self
You can't remember anything about yourself whether it's your name or how you look. Your head hurts a bit suggesting that your amnesia comes from blunt force trauma.

>xyzzy
That's not a verb I recognise.

>find saw
That's not a verb I recognise.

>take saw
You can't see any such thing.

>nw
Forest Clearing
Sunlight filters through the leaves of the trees above. You can see the Pine Tree Trail to the southwest and a Waterfall to the southeast.

You can see Stranger here.

>take saw
You can't see any such thing.

>sw
Pine Tree Trail
A fairly normal hiking trail full of pine trees.  You can see the a Rocky Field to the south, a Forest Clearing to the northeast and a Bridge to the east. At a closer glance you can see the bush from the photo.

>take saw
Taken.

>i
You are carrying:
  Saw
  Telescope
  Cell Phone

>look at bush
A rather plain looking bush. You can see a large metalic thing under the bush.

>investigate thing
That's not a verb I recognise.

>look at thing
You can't see any such thing.

>i
You are carrying:
  Saw
  Telescope
  Cell Phone

>look at saw
It's a large metal saw that looks useful for cutting

>use saw
That's not a verb I recognise.

>e
Bridge
A rope bridge built atop a flowing river. It occasionally sways from side to side making you question its architectural integrity. You can see a Pine Tree Trail to the west, and a Waterfall to the east.

>cut bridge
You walk right off of the easternmost side of the bridge. You cut the rope supports of the bridge and the wodden rope structure falls to the other side of the ravine. Now there's a vast gap in the bridge's place.

Waterfall
A huge waterfall roars above. You can see the Bridge to the west and the Forest Clearing to the northwest.

>nw
Forest Clearing
Sunlight filters through the leaves of the trees above. You can see the Pine Tree Trail to the southwest and a Waterfall to the southeast.

You can see Stranger here.

* * *

>talk
(to Stranger)
"Shoots it's her" Stranger mutters before running towards the Pine Tree Trail.

>sw
Pine Tree Trail
A fairly normal hiking trail full of pine trees.  You can see the a Rocky Field to the south, a Forest Clearing to the northeast and a Bridge to the east. At a closer glance you can see the bush from the photo. 

You can see Stranger here.

>talk
(to Stranger)
Stranger gawks at the broken bridge and runs towards the Rocky Field instead.

* * *

>s
Rocky Field
A dirt covered field with rocks scattered about. A high cliff looms above casting a shadow over much of the field. You can see a Pine Tree Trail to the north and a Grassy Meadow to the west.

You can see Stranger here.

>talk
(to Stranger)
"You're a persistant one" Stranger mutters as he sprints towards the grassy meadow.

* * *

>w
Grassy Meadow
Patches of grass and wildflowers fill the meadow. It's surrounded by a rather tall fence. You can see a gate to the west, the Rocky Field to the east and a pathway leading to the south.

You can see Gate, Stranger and Daisy here.

>look at gate
You see nothing special about Gate.

>talk to daisy
You can only do that to something animate.

>talk to stranger
"You're a persistant one" Stranger mutters as he sprints towards the southern path.

* * *

>s
Cliff
A sheer cliff overlooking the Rocky Field. The Grassy Meadow is to the north.

You can see Stranger here.

>talk
(to Stranger)
After taking a look around, the Stranger sees that there is no where to run and resigns himself to his fate.
 "What are the chances that we'd end up here" he mutters to himself as you walk towards him.
"Who are you?" you ask.
"What?!?"
"I swear, I never even met you but you keep on running away."
    "…"        "I think I lost my memory but for some reason I have pictures of you in my phone. Do you have any idea about who I am?"        "I see… You are not someone I know personally I am not against cooperating with you to get out of this place.Ķho .ht"    You agree to cooperate with the stranger.
"By the way, my name is Landon, Landon Meyers."

>talk
(to Landon)
Landon shuffles with the backpack he's wearing and passes you a keycard. "This activates something in the gate, but doesn't open it" he says.

>take
(Landon)
I don't suppose Landon would care for that.

>take keycard
You already have that.

>look at card
You can't see any such thing.

>look at keycard
You see nothing special about Keycard.

>n
Grassy Meadow
Patches of grass and wildflowers fill the meadow. It's surrounded by a rather tall fence. You can see a gate to the west, the Rocky Field to the east and a pathway leading to the south.

You can see Gate, Landon and Daisy here.

>use keycard
That's not a verb I recognise.

>w
(first opening Gate)
It seems to be locked.

>cut gate
This seems like a waste of time.

>cut fence
You can't see any such thing.

>n
You can't go that way.

>s
Cliff
A sheer cliff overlooking the Rocky Field. The Grassy Meadow is to the north.

You can see Landon here.

>talk]
That's not a verb I recognise.

>talk
(to Landon)
"If there's something you want to ask me, go for it."

>where are we
That's not a verb I recognise.

>ask landon where we are
I didn't understand that sentence.

>ask
What do you want to ask Landon for?

>ask about place
You can't see any such thing.

>ask about gate
You can't see any such thing.

>ask about self
You can't see any such thing.

>ask about daisy
You can't see any such thing.

>ask landon about gate
"You can unlock it with a keycard, but then you have to input some code. 1111 doesn't work by the way."

>ask landon about daisy
There is no reply.

>ask landon about landon
"My past is none of your business. Just because we we're working together doesn't mean we're friends or anything.
You think you've bonded with Landon.

>ask landon about self
"You want me to tell you about yourself? I can't tell you much other than physical appearance though. Twentyish, brown haired with a ponytail. You look pretty average too me. Hey? Why are you looking at me like that?"
You think you've bonded with Landon.

>ask landon about situation
There is no reply.

>ask landon about existence
There is no reply.

>n
Grassy Meadow
Patches of grass and wildflowers fill the meadow. It's surrounded by a rather tall fence. You can see a gate to the west, the Rocky Field to the east and a pathway leading to the south.

You can see Gate, Landon and Daisy here.

* * *

>unlock gate with keycard
You need to "input a four digit code into the Digital Lock". There's a hint below saying "the last four digits". If I thought the password maker was a minimalist, I might "input 1111 into the Digital Lock".

>i
You are carrying:
  Keycard
  Saw
  Telescope
  Cell Phone

>read keycard
You see nothing special about Keycard.

>read saw
It's a large metal saw that looks useful for cutting

>read telescope
A telescope pointed towards nearby scenery. It's so detailed you can see individual leaves on trees.

There's a large gap where the bridge used to be.

>cellphone
That's not a verb I recognise.

>look at cellphone
You can't see any such thing.

>examine cell phone
An ordinary picture phone that just might be mine. Maybe if I rummage through the pictures or contact information, I'll be able to find out who I am. I should "select Photo Menu" or "select Contacts Menu".

>select contacts meny
I only understood you as far as wanting to select Contacts Menu.

>select contacts menu
From here you can view your phone's contacts.

In Contacts Menu are My Number and Mom's Number.

* * *

>my number
That's not a verb I recognise.

>examine my number
4442302

>input 2302
You hear a wonderful chiming sound as the screen fades to black and the Digital Lock opens .

* * *

>w
(first opening Gate)
As soon as you open the gate, Landon runs off into the distance without even a goodbye.

Street
Finally we've reached civilization. Maybe my phone actually gets reception here.

You can see Gate here.

>call mom
Someone in my contacts list called "Mom" should know about me right? I try calling, but it appears that I'm out of range. Maybe if I could get to civilization…pears th

>w
You can't go that way.

>n
You can't go that way.

I beg your pardon?

>call mom with cell phone
I only understood you as far as wanting to call Mom's Number.

>call mom's number
Someone in my contacts list called "Mom" should know about me right? I try calling, but it appears that I'm out of range. Maybe if I could get to civilization…pears Ằat I

* * *

>take phone
Taken.

>go west
Grassy Meadow
Patches of grass and wildflowers fill the meadow. It's surrounded by a rather tall fence. You can see a gate to the west, the Rocky Field to the east and a pathway leading to the south.

You can see Gate and Daisy here.

>look at daisy
A cute white daisy. This flower looked a little lonely so I just had to pick him up.

* * *

>take daisy
Taken.

>go west
(first opening Gate)
It seems to be locked.

* * *

>go east
Rocky Field
A dirt covered field with rocks scattered about. A dark shadow casts itself over much of the field. You can see a Pine Tree Trail to the north and a Grassy Meadow to the west.

>look at phone
An ordinary picture phone that just might be mine. Maybe if I rummage through the pictures or contact information, I'll be able to find out who I am. I should "select Photo Menu" or "select Contacts Menu".

* * *

>select photo menu
From here you can view the phone's photo collection. You can use the commands "next photo" and "previous photo" to browse through the photos.

In Photo Menu are Photo 1, Photo 2 and Photo 3.

>look at photo 1
It's a picture of a house. It's a modern one story model with solar panels and everything. Behind it there's a gate surrounded by a grassy field.

* * *

>next photo
(Cell Phone)
It's a picture of a young man doing something next to a rather plain looking bush. There are many pine trees in the background.

>go north
Pine Tree Trail
A fairly normal hiking trail full of pine trees.  You can see the a Rocky Field to the south, a Forest Clearing to the northeast and a Bridge to the east. At a closer glance you can see the bush from the photo.

* * *

>take metalic thing
Taken.

>go east
Bridge
A rope bridge built atop a flowing river. It occasionally sways from side to side making you question its architectural integrity. You wouldn't be able to damage the bridge with your bare hands, but with the right tools, who knows what you could do. You can see a Pine Tree Trail to the west, and a Waterfall to the east.

* * *

>go west
Bridge
A rope bridge built atop a flowing river. It occasionally sways from side to side making you question its architectural integrity. You wouldn't be able to damage the bridge with your bare hands, but with the right tools, who knows what you could do. You can see a Pine Tree Trail to the west, and a Waterfall to the east.

>cut bridge
You walk right off of the easternmost side of the bridge. You cut the rope supports of the bridge and the wodden rope structure falls to the other side of the ravine. Now there's a vast gap in the bridge's place.

Waterfall
A huge waterfall roars above. You can see the Bridge to the west and the Forest Clearing to the northwest.

* * *

>go northwest
Forest Clearing
Sunlight filters through the leaves of the trees above. You can see the Pine Tree Trail to the southwest and a Waterfall to the southeast.

You can see Stranger here.

>talk to stranger
"Shoots it's her" Stranger mutters before running southwest towards the Pine Tree Trail.

* * *

>go southwest
Pine Tree Trail
A fairly normal hiking trail full of pine trees.  You can see the a Rocky Field to the south, a Forest Clearing to the northeast and a Bridge to the east. At a closer glance you can see the bush from the photo. 

You can see Stranger here.

>talk to stranger
Stranger gawks at the broken bridge and runs south towards the Rocky Field instead.

>go south
Rocky Field
A dirt covered field with rocks scattered about. A dark shadow casts itself over much of the field. You can see a Pine Tree Trail to the north and a Grassy Meadow to the west.

You can see Stranger here.

* * *

>talk to stranger
"You're a persistant one" Stranger mutters as he sprints towards the southern path.

>go wouth
You can't see any such thing.

>go south
Cliff
A sheer cliff overlooking the Rocky Field. The Grassy Meadow is to the north.

You can see Stranger here.

* * *

>talk to landon
Landon shuffles with the backpack he's wearing and passes you a keycard. "This activates something in the gate, but doesn't open it" he says.

>ask landon about murder
There is no reply.

>ask landon about crimes
There is no reply.

>ask landon about himself
"My past is none of your business. Just because we we're working together doesn't mean we're friends or anything.
You think you've bonded with Landon.

>ask landon about me
"You want me to tell you about yourself? I can't tell you much other than physical appearance though. Twentyish, brown haired with a ponytail. You look pretty average too me. Hey? Why are you looking at me like that?"
You think you've bonded with Landon.

>ask landon about waterfall
There is no reply.

>ask landon about cliff
"Looking at the Rocky Field below… nevermind"

>ask landon about meadow
There is no reply.

>ask landon about grassy meadow
"It's a nice place. Not like I want to go there."

>ask landon about rocky field
"I don't like that place."

>show landon daisy
Landon twirls the flower in his hand a bit. "Oh, you want it back, here then."

>give landon daisy
"For me? I'm not a girl you know but… thanks."
You think you've bonded with Landon.

>show landon telescope
Landon takes a look at the destroyed bridge. "And you're saying you did this so trap me? Talk about collateral damage."

>i
You are carrying:
  Keycard
  Telescope
  Saw
  Cell Phone

>scire
That's not a verb I recognise.

>score
You have so far scored 0 out of a possible 0, in 44 turns.

>show landon cell phone
Landon is unimpressed.

>show landon keycard
Landon is unimpressed.

>show landon saw
"It's a useful item isn't it."

>give landon saw
Landon doesn't seem interested.

>go west
You can't go that way.

>go east
You can't go that way.

>look
Cliff
A sheer cliff overlooking the Rocky Field. The Grassy Meadow is to the north.

You can see Landon here.

* * *

>go west
(first opening Gate)
It seems to be locked.

>ask landon about saw
There is no reply.

>ask landon about bush
There is no reply.

>go east
Rocky Field
A dirt covered field with rocks scattered about. A dark shadow casts itself over much of the field. You can see a Pine Tree Trail to the north and a Grassy Meadow to the west.

You can see Landon here.

>go north
Pine Tree Trail
A fairly normal hiking trail full of pine trees.  You can see the a Rocky Field to the south, a Forest Clearing to the northeast and a Bridge to the east. At a closer glance you can see the bush from the photo. 

You can see Landon here.

>ask landon about bush
There is no reply.

>show landon bush
(first taking Bush)
That's hardly portable.

>show landon saw
"It's a useful item isn't it."

>ask landon about saw
There is no reply.

>!@#$%^ landon
That's not a verb I recognise.

>go south
Rocky Field
A dirt covered field with rocks scattered about. A dark shadow casts itself over much of the field. You can see a Pine Tree Trail to the north and a Grassy Meadow to the west.

You can see Landon here.

>go west
Grassy Meadow
Patches of grass and wildflowers fill the meadow. It's surrounded by a rather tall fence. You can see a gate to the west, the Rocky Field to the east and a pathway leading to the south.

You can see Gate and Landon here.

>go wst
You can't see any such thing.

>go west
(first opening Gate)
It seems to be locked.

>unlock gate
What do you want to unlock Gate with?

* * *

>keycard
You need to "input a four digit code into the Digital Lock". There's a hint below saying "the last four digits". If I thought the password maker was a minimalist, I might "input 1111 into the Digital Lock".

>input 2302
You hear a wonderful chiming sound as the screen fades to black and the Digital Lock opens .

* * *

>open gate
As soon as you open the gate, Landon runs off into the distance without even a goodbye.

>undo
Grassy Meadow
[Previous turn undone.]

>show landon photo 1
(first taking Photo 1)
Landon is unimpressed.

>show landon phot 2
You can't see any such thing.

>show landon photo 2
(first taking Photo 2)
"It's a picture of you isn't it? What about it?"

>show landon photo 3
(first taking Photo 3)
"It's me… Are you some sort of stalker?"
You think you've bonded with Landon.

>open gate
As soon as you open the gate, Landon runs off into the distance without even a goodbye.

* * *

>w
Grassy Meadow
Patches of grass and wildflowers fill the meadow. It's surrounded by a rather tall fence. You can see a gate to the west, the Rocky Field to the east and a pathway leading to the south.

You can see Gate and Daisy here.

>input 2302
I don't see anything to input numbers into.

>w
(first opening Gate)
As soon as you open the gate, Landon runs off into the distance without even a goodbye.

Street
Finally we've reached civilization. Maybe my phone actually gets reception here.

You can see Gate here.

>call mom
You can't see any such thing.

>call mom
You can't see any such thing.

* * *

>input 2302
I don't see anything to input numbers into.

>e
Rocky Field
A dirt covered field with rocks scattered about. A dark shadow casts itself over much of the field. You can see a Pine Tree Trail to the north and a Grassy Meadow to the west.

You can see Cell Phone here.

>take phone
Taken.

* * *

>n
Pine Tree Trail
A fairly normal hiking trail full of pine trees.  You can see the a Rocky Field to the south, a Forest Clearing to the northeast and a Bridge to the east.

>e
Bridge
A rope bridge built atop a flowing river. It occasionally sways from side to side making you question its architectural integrity. You wouldn't be able to damage the bridge with your bare hands, but with the right tools, who knows what you could do. You can see a Pine Tree Trail to the west, and a Waterfall to the east.

>w
Pine Tree Trail
A fairly normal hiking trail full of pine trees.  You can see the a Rocky Field to the south, a Forest Clearing to the northeast and a Bridge to the east.

>take saw
Taken.

* * *

>s
Cliff
A sheer cliff overlooking the Rocky Field. The Grassy Meadow is to the north.

You can see Stranger here.

>talk
(to Stranger)
After taking a look around, the Stranger sees that there is no where to run and resigns himself to his fate.
 "What are the chances that we'd end up here" he mutters to himself as you walk towards him.
"Who are you?" you ask.
"What?!?"
"I swear, I never even met you but you keep on running away."
    "…"        "I think I lost my memory but for some reason I have pictures of you in my phone. Do you have any idea about who I am?"        "I see… You are not someone I know personally I am not against cooperating with you to get out of this place. †"    You agree to cooperate with the stranger.
"By the way, my name is Landon, Landon Meyers."

>talk
(to Landon)
Landon shuffles with the backpack he's wearing and passes you a keycard. "This activates something in the gate, but doesn't open it" he says.

* * *

>w
Grassy Meadow
Patches of grass and wildflowers fill the meadow. It's surrounded by a rather tall fence. You can see a gate to the west, the Rocky Field to the east and a pathway leading to the south.

You can see Gate and Daisy here.

>x grass
Green and pokey. It looks comfortable to sleep on.

* * *

>w
Grassy Meadow
Patches of grass and wildflowers fill the meadow. It's surrounded by a rather tall fence. You can see a gate to the west, the Rocky Field to the east and a pathway leading to the south.

You can see Gate and Daisy here.

>take daisy
Taken.

>look
Grassy Meadow
Patches of grass and wildflowers fill the meadow. It's surrounded by a rather tall fence. You can see a gate to the west, the Rocky Field to the east and a pathway leading to the south.

You can see Gate here.

>i
You are carrying:
  Daisy