Cellphone Picture Mystery
An Interactive Fiction by Crystal Yee
Release 1 / Serial number 130308 / Inform 7 build 6G60 (I6/v6.32 lib 6/12N) SD

Rocky Field
A dirt covered field with rocks scattered about. A high cliff looms above casting a shadow over much of the field. You can see a Tree Lined Trail to the north and a Grassy Meadow to the west.

You can see Keycard here.

>w
Grassy Meadow
Patches of grass and wildflowers fill the meadow. It's surrounded by a rather tall fence. You can see a gate to the west.

You can see Gate here.

>w
(first opening Gate)
It seems to be locked.

>e
Rocky Field
A dirt covered field with rocks scattered about. A high cliff looms above casting a shadow over much of the field. You can see a Tree Lined Trail to the north and a Grassy Meadow to the west.

You can see Keycard here.

>n
Tree Lined Trail
A fairly normal hiking trail full of pine trees. A bush lies ostentaniously on the left hand side of the trail. You can see the a Rocky Field to the south, a Forest Clearing to the northeast and a Bridge to the east.

>e
Bridge
A rope bridge built atop a flowing river. It occasionally sways from side to side making you question its architectural integrity. You can see a Tree Lined Trail to the west, and a Waterfall to the east.

>e
Waterfall
A huge waterfall roars above. You can see the Bridge to the west and the Forest Clearing to the northwest.

You can see Telescope here.

>examine telescope
You see nothing special about Telescope.

 You can see a bridge in the distance. , There's a large gap where the bridge used to be.

>e
You can't go that way.

>w
Bridge
A rope bridge built atop a flowing river. It occasionally sways from side to side making you question its architectural integrity. You can see a Tree Lined Trail to the west, and a Waterfall to the east.

>w
Tree Lined Trail
A fairly normal hiking trail full of pine trees. A bush lies ostentaniously on the left hand side of the trail. You can see the a Rocky Field to the south, a Forest Clearing to the northeast and a Bridge to the east.

>take saw
Taken.

>e
Bridge
A rope bridge built atop a flowing river. It occasionally sways from side to side making you question its architectural integrity. You can see a Tree Lined Trail to the west, and a Waterfall to the east.

>cut bridge with saw
You walk right off of the easternmost side of the bridge. You cut the rope supports of the bridge and the wodden rope structure falls to the other side of the ravine. Now there's a vast gap in the bridge's place.

Waterfall
A huge waterfall roars above. You can see the Bridge to the west and the Forest Clearing to the northwest.

You can see Telescope here.

>examine telescope
You see nothing special about Telescope.

 You can see a bridge in the distance.

I beg your pardon?

* * *

>e
Rocky Field
A dirt covered field with rocks scattered about. A high cliff looms above casting a shadow over much of the field. You can see a Tree Lined Trail to the north and a Grassy Meadow to the west.

You can see Keycard here.

>take keycard
Taken.

>w
Grassy Meadow
Patches of grass and wildflowers fill the meadow. It's surrounded by a rather tall fence. You can see a gate to the west.

You can see Gate here.

* * *

>w
(first opening Gate)
It seems to be locked.

>open gate
It seems to be locked.

* * *

>w
Grassy Meadow
Patches of grass and wildflowers fill the meadow. It's surrounded by a rather tall fence. You can see a gate to the west.

You can see Gate here.

>e
Rocky Field
A dirt covered field with rocks scattered about. A high cliff looms above casting a shadow over much of the field. You can see a Tree Lined Trail to the north and a Grassy Meadow to the west.

You can see Keycard here.

* * *

>e
Bridge
A rope bridge built atop a flowing river. It occasionally sways from side to side making you question its architectural integrity. You can see a Tree Lined Trail to the west, and a Waterfall to the east.

>e
Waterfall
A huge waterfall roars above. You can see the Bridge to the west and the Forest Clearing to the northwest.

* * *

>n
Tree Lined Trail
A fairly normal hiking trail full of pine trees. A bush lies ostentaniously on the left hand side of the trail. You can see the a Rocky Field to the south, a Forest Clearing to the northeast and a Bridge to the east.

>n
You can't go that way.

>e
Bridge
A rope bridge built atop a flowing river. It occasionally sways from side to side making you question its architectural integrity. You can see a Tree Lined Trail to the west, and a Waterfall to the east.

* * *

>e
Waterfall
A huge waterfall roars above. You can see the Bridge to the west and the Forest Clearing to the northwest.

You can see Telescope here.

>w
Bridge
A rope bridge built atop a flowing river. It occasionally sways from side to side making you question its architectural integrity. You can see a Tree Lined Trail to the west, and a Waterfall to the east.

* * *

>cut bridge with saw
You walk right off of the easternmost side of the bridge. You cut the rope supports of the bridge and the wodden rope structure falls to the other side of the ravine. Now there's a vast gap in the bridge's place.

Waterfall
A huge waterfall roars above. You can see the Bridge to the west and the Forest Clearing to the northwest.

You can see Telescope here.

>w
Without the bridge it's impossible to cross.

* * *

>w
Grassy Meadow
Patches of grass and wildflowers fill the meadow. It's surrounded by a rather tall fence. You can see a gate to the west.

You can see Gate here.

>open gae
You can't see any such thing.

>open gate
It seems to be locked.

>unlock gate with keycard
You need to "input a four digit code into the Digital Lock". If I thought the password maker was a minimalist, I might "input 1111 into the Digital Lock".

* * *

Cellphone Picture Mystery
An Interactive Fiction by Crystal Yee
Release 1 / Serial number 130308 / Inform 7 build 6G60 (I6/v6.32 lib 6/12N) SD

Rocky Field
A dirt covered field with rocks scattered about. A high cliff looms above casting a shadow over much of the field. You can see a Tree Lined Trail to the north and a Grassy Meadow to the west.

You can see Keycard here.

>n
Tree Lined Trail
A fairly normal hiking trail full of pine trees. A bush lies ostentaniously on the left hand side of the trail. You can see the a Rocky Field to the south, a Forest Clearing to the northeast and a Bridge to the east.

>w
You can't go that way.

>w
You can't go that way.

>s
Rocky Field
A dirt covered field with rocks scattered about. A high cliff looms above casting a shadow over much of the field. You can see a Tree Lined Trail to the north and a Grassy Meadow to the west.

You can see Keycard here.

>w
Grassy Meadow
Patches of grass and wildflowers fill the meadow. It's surrounded by a rather tall fence. You can see a gate to the west.

You can see Gate here.

* * *

>e
Rocky Field
A dirt covered field with rocks scattered about. A high cliff looms above casting a shadow over much of the field. You can see a Tree Lined Trail to the north and a Grassy Meadow to the west.

You can see Keycard here.

>take all
(Keycard)
Taken.

>w
Grassy Meadow
Patches of grass and wildflowers fill the meadow. It's surrounded by a rather tall fence. You can see a gate to the west.

You can see Gate here.

>open gate
It seems to be locked.

>unlock gate
(with Keycard)
You need to "input a four digit code into the Digital Lock". There's a hint below saying "the last four digits". If I thought the password maker was a minimalist, I might "input 1111 into the Digital Lock".

>input 2302 into the digital lock
You hear a wonderful chiming sound as the screen fades to black and the Digital Lock opens .

>open gate
You open Gate.

* * *

>e
Waterfall
A huge waterfall roars above. You can see the Bridge to the west and the Forest Clearing to the northwest.

You can see Telescope here.

>e
You can't go that way.

I beg your pardon?

* * *

>e
You can't go that way.

>e
You can't go that way.

* * *

I beg your pardon?

>actions on
Actions listing on.

>w
[going west]
[going west - failed]

* * *

>e
Waterfall
A huge waterfall roars above. You can see the Bridge to the west and the Forest Clearing to the northwest.

You can see Telescope here.

>x telescope
You see nothing special about Telescope.

* * *

>n
Tree Lined Trail
A fairly normal hiking trail full of pine trees. A bush lies ostentaniously on the left hand side of the trail. You can see the a Rocky Field to the south, a Forest Clearing to the northeast and a Bridge to the east.

>take saw
Taken.

>w
You can't go that way.

>e
Bridge
A rope bridge built atop a flowing river. It occasionally sways from side to side making you question its architectural integrity. You can see a Tree Lined Trail to the west, and a Waterfall to the east.

>w
Tree Lined Trail
A fairly normal hiking trail full of pine trees. A bush lies ostentaniously on the left hand side of the trail. You can see the a Rocky Field to the south, a Forest Clearing to the northeast and a Bridge to the east.

>e
Bridge
A rope bridge built atop a flowing river. It occasionally sways from side to side making you question its architectural integrity. You can see a Tree Lined Trail to the west, and a Waterfall to the east.

* * *

>e
Waterfall
A huge waterfall roars above. You can see the Bridge to the west and the Forest Clearing to the northwest.

You can see Telescope here.

>x telescope
You see nothing special about Telescope.

 You can see a bridge in the distance. There's a large gap where the bridge used to be.

>w
Bridge
A rope bridge built atop a flowing river. It occasionally sways from side to side making you question its architectural integrity. You can see a Tree Lined Trail to the west, and a Waterfall to the east.

>cut bridge with saw
You walk right off of the easternmost side of the bridge. You cut the rope supports of the bridge and the wodden rope structure falls to the other side of the ravine. Now there's a vast gap in the bridge's place.

Waterfall
A huge waterfall roars above. You can see the Bridge to the west and the Forest Clearing to the northwest.

You can see Telescope here.

>x telescope
You see nothing special about Telescope.

 You can see a bridge in the distance. There's a large gap where the bridge used to be.

* * *

>cut bridge with saw
You walk right off of the easternmost side of the bridge. You cut the rope supports of the bridge and the wodden rope structure falls to the other side of the ravine. Now there's a vast gap in the bridge's place.

Waterfall
A huge waterfall roars above. You can see the Bridge to the west and the Forest Clearing to the northwest.

You can see Telescope here.

I beg your pardon?

* * *

>w
Without the bridge it's impossible to cross.

I beg your pardon?

>w
Without the bridge it's impossible to cross.

* * *

>e
Bridge
A rope bridge built atop a flowing river. It occasionally sways from side to side making you question its architectural integrity. You can see a Tree Lined Trail to the west, and a Waterfall to the east.

>cut bridge
Cutting that up would achieve little.

>cut bridge with saw
You walk right off of the easternmost side of the bridge. You cut the rope supports of the bridge and the wodden rope structure falls to the other side of the ravine. Now there's a vast gap in the bridge's place.

Waterfall
A huge waterfall roars above. You can see the Bridge to the west and the Forest Clearing to the northwest.

* * *

>take saw
Taken.

>east
Bridge
A rope bridge built atop a flowing river. It occasionally sways from side to side making you question its architectural integrity. You can see a Tree Lined Trail to the west, and a Waterfall to the east.

>cut bridge with saw
You walk right off of the easternmost side of the bridge. You cut the rope supports of the bridge and the wodden rope structure falls to the other side of the ravine. Now there's a vast gap in the bridge's place.

Waterfall
A huge waterfall roars above. You can see the Bridge to the west and the Forest Clearing to the northwest.

You can see Telescope here.

* * *

Cellphone Picture Mystery
An Interactive Fiction by Crystal Yee
Release 1 / Serial number 130308 / Inform 7 build 6G60 (I6/v6.32 lib 6/12N) SD

Rocky Field
A dirt covered field with rocks scattered about. A high cliff looms above casting a shadow over much of the field. You can see a Tree Lined Trail to the north and a Grassy Meadow to the west.

You can see Keycard here.

>take all
(Keycard)
Taken.

* * *

>open gate
It seems to be locked.

>unlock gate with keycard
You need to "input a four digit code into the Digital Lock". There's a hint below saying "the last four digits". If I thought the password maker was a minimalist, I might "input 1111 into the Digital Lock".

>2302
That's not a verb I recognise.

>input 2302 into the Digital Lock
You hear a wonderful chiming sound as the screen fades to black and the Digital Lock opens .

>unlock gate
(with Keycard)
You need to "input a four digit code into the Digital Lock". There's a hint below saying "the last four digits". If I thought the password maker was a minimalist, I might "input 1111 into the Digital Lock".

* * *

Cellphone Picture Mystery
An Interactive Fiction by Crystal Yee
Release 1 / Serial number 130308 / Inform 7 build 6G60 (I6/v6.32 lib 6/12N) SD

Rocky Field
A dirt covered field with rocks scattered about. A high cliff looms above casting a shadow over much of the field. You can see a Tree Lined Trail to the north and a Grassy Meadow to the west.

You can see Keycard here.

>e
You can't go that way.

>n
Tree Lined Trail
A fairly normal hiking trail full of pine trees. A bush lies ostentaniously on the left hand side of the trail. You can see the a Rocky Field to the south, a Forest Clearing to the northeast and a Bridge to the east.